----------------------------------------------------------------------------------------------------
----------------------------------------------------------------------------------------------------
----------------------------------------------------------------------------------------------------
----------------------------------------------------------------------------------------------------
------------------------------------------------------------xxxxxxxxxxx-----------------------------
-----------------------------------SSSSSSSSS?SS-----------xxx---x---XX-x------------SSSS------------
-----ES--------------E--------------[]-------------------xx-E---E---[]--x------------[]-------------
-----------QQQ------<>--------------[]------------------xx----------[]---x-----------[]-------------
--------------------[]--------------[]--------------xxxxx-----------[]----x----------[]-------------
-----------------QQQQQQQQQQ---------[]----SSS------xx-XXX-----------[]-----xx--------[]-----------xx
xx----------------------------------<>------------xx----------------<>-----B-x-------<>----------xxE
B-x----------xxxxx------------------xxx------xxxxxx------------------------b--x------xxx--------xx<>
b--xxxxxxxxxxxB---xxxxxxxxxxxxxxxxxxxE-xxxxxxx---x-------------------E-----B---xxxxxxxE-xxxxxxxxx-[]
XXXXXXXXXXXXXXX--XXXXXEEXXXXXXXXXXXXXXXXXXXXXX-X-X-----------------XXXXXXXXXXXXXXXXXXXXXXXXEXXXXXXXX