xxx-------------------------------------------------------------------------------------------------
x--x------------------------------------------------------------------------------------------------
X---x------------SSSSSSSSSSSSSSSSSSSSSSSSSSSSSSSSSSSSSSSSSSSSSSSSSSSSSSSSSSSSSSSSSSSSSSSSSSSSSSSSSSS
X----x-------------[]----[]------------------------------------------------SSSSSSSSSSSSSS---------[]
X-----x------------[]----[]-------E---------------xxx----------------------SSSSSSSSSSSSSS---------[]
X------x-----------[]----[]---QQQQQQ--------xxxxxxx--x---------------------SSSSSSSSSSSSSS---------[]
X-------x----------<>----[]----------------xxSSSSSS---xxxxx------------------------------ox-------[]
X--------x---------------[]---------------xx-SSSSSS--SSSSS-x--------------------------xxxx--------[]
X---------x--------------[]--xxxxxxxxxxxxxx--SSSSSS--SSSSS--xxxxxxxxxxxxxxxxxxxxxxxxxxx----x------[]
X----------x-------------[]-xxSSSSSSSSSSSSS--SSSSSS--SSSSS?SS?SSSSS????????SSSSSSSSSSS?-----x-----[]
X-----------x------------<>xx-SSSSSSSSSSSSS------------------SSSSSSSSSSSSSS------------------x----<>
X------------x----xxx-----xx--SSSSSSSSSSSSS--------<>--------SSSSSSSSSSSSSS-------------<>----x----x
X-----------X-xxxxx--xxxxxx---SSSSSSSSSSSSS--------[]-----------------------------------[]-----xxxxx
X--XXXXXXXXXXXXXXXX--XXXXXXE--XXXXXXXXXXXXXXXXXXXXXXXXXXXXXXXXX-XX-XXXXXXXXXXXXXXXXXXXXXXXXXXXXXXXXX