------------------------------------------------------------------------------------------xxx-------
-----------------------------------------------------------------------------------------xx--x------
----------------------------S-----------------------------------------------------------xx----x-----
---------------------------------------------------------------------------------------xx------x---x
--------------------------------------------------------xxxx-------------------------xxxE-------x-xx
--------------------------XXXX-------------------------xxXX-x-----------------------xx-<>--------xx-
--------------------------XXX---------E-------E-------xxXXX--x---------------------xx--[]--------XX-
-----------------------------------------------------xxXXXX---x----------------xxxxx---[]-----------
--xxxx-xxxxx-Exxxxx--xxx----------------------------xxXXXXX----x-----------xxxxx--xE---[]-----------
-xx---xx----xxx----xxx--x--------------------------xxXXXXXX-----x---------xxXXXX--<>---[]-----------
xx---XXX----XXX----XXX---x------------------------xxXXXXXXX------x-------xx-------[]---[]-----------
x----XX-----XX-----XX-----xx---------------------xxXXXXXXXX-------x-----xx--------[]---[]-----------
B------------------------XX-xxxxxxxxxxxxxxxxxxxxxxXXXXXXXXX--------xxxxxx--X------[]---[]-----------
X------------------------XXXXXXXXXXXXXXXXXXXXXXXXXXXXXXXXXXXXXXXXXXXXXXXXXXXXX----[]---XX-XXX-------