----------------------------------------------------------------------------------------------------
-----------------------------------------------------------------------------------------------xx---
----------------------------------------------------------------------------------------------xx-xxx
---------xxx---------------------------------------------------------------------------------xx--XX-
-------xxx--x-------------------------------------------------------------------------------xx---XX-
------xxXX---x--------------------------------------------------------SSSSSS---?-------xxx--xS---XX-
-----xxXXX----x-----------------------------------------------------------------------xx--x-x----XX-
----xxXXXX-----x---------------------------------------------------------------------xx----xx----XX-
---xxXXXXX------x-------------Q--?--------------------------------------------------xx------x----XX-
--xx-XXXXX-------x---------Q-E------ESSS----E------------------E---S---E----------xxx-------SS---XX-
xxx--XXXXX--------x----------E-------------<>-----------------<>-------------E---xx<>------------XX-
x<>-XXXXXX---------x-----------------------------xxxxx--------------------------xx-[]------------XX-
-[]XXXXXXX--------X-xxxxxxxxxxxxxxxxxxxxxxxxxxxxxx----xxxxxxxxxxxxxxxxxxxxxxxxxxx--[]E-----------XX-
XXXXXXXXXXXXXXXXXXXXXXXXXXXXXXXXXXXXXXXXXXXXXXXXXX---XXXXXXXXXXXXXXXXXXXXXXXXXXXXXXXXXXXXXXXXXXXXXXX