--------------------xxx-----------------------------------------------------------------------------
--------------------x--x----------------------------------------------------------------------------
[]SSSSSSSSSSSSSSSSSSS---x---SSSSSSSSSSSSSSSS-------------SSS--[]SSSSSSS-----------------------------
[]SSSSS------------------x--SSSS------------------------------[]SSSSSSS-----------------------------
[]SSSSS-------------------x-SSSS------------------------------[]SSSSSSS-----------------------------
[]SSSS---------------------xSSSS-------------xx--xxxxx--------[]SSSSSSS-------------------------XXXX
[]S-------------------------x---------------xx-xxx----x-------[]SSSSSSS------E----------------------
[]S--------------------------x-------------xx--XXX-----x------[]SSSSSSS--------------------------xxx
<]S--------------------------oxxx------xxxxx------------x------]SSSSSSS-------------------xxxxxxxx--
[]S-------------------------S?SS-x----xx-XXX-------------xxxxx-]SSSSSSS------------------xxXEXXXXXEX
SSS--------------XXXX-------SSS---x--xx-----------SSS-S--SSSSSSSSSSSSSS---------S------xxx----------
S---------------------------SS-----xxx------------SSS-S--SSSSSSSSSSSSSS--<>-----------xxXXX---------
-EE---------E-----------------E-EE--xX------------SSS-S--SSSSSSSSSSSSSS--[]-------xxxxx-------------
XXXXXXXXXXXXXXXXXXXXX---XXXXXX-XXXXXXX---------XXXSSS-S--XXXXXXXXXXXXXX--XX------XXXXXXXXXX---------