----------------------------------------------------------------------------------------------------
----------------------------------------------------------------------------------------------------
--------SSS--[]SSSSSSSSSSSSSSS---------------------------------S------------------------------------
-------------[]SSSSSSSSSSSSSSS-------------------XXXXXXXXXXXX--S------------------------------------
-------------[]SSSSSSSSSSSSSSS------------------XX-------------S-------------xxxxxxxxxxx------------
xxxxx--------[]SSSSSSSSSSSSSSS-----------------XXX-------------S------------xx---x---XX-x-----------
x----x-------[]SSSSSSSSSSSSSSS----------------XXXX-------------S-----------xx-E--E---[]--x----------
X-----x------[]SSSSSSSSSSSSSSS---------------XXXXX-------------S---------xxx---------[]---x---------
-------x------]SSSSSSSSSSSSSSS--------------XXXXXX-------------S--------xx-E---------[]----x--------
--------xxxxx-]SSSSSSSSSSSSSSS--------E----XXXXXXX-------------S--------x------------[]-----xx------
-SSS-S--SSSSSSSSSSSSSSSSSSSSSS---E---<>---XXXXXXXX-----<>------S-------xx------------<>-----B-x-----
XSSS-S--SSSSSSSSSSSSSSSSSSSSSS--<>---[]--XXXXXXXXX-----[]------S------xx--------------------b--x----
-SSS-S--SSSSSSSSSSSSSSSSSSSSSS--[]---[]-XXXXXXXXXX-----[]------Sxxxxxxx---------------E-----B---xxxx
XSSS-S--XXXXXXXXXXXXXXXXXXXXXX--XX---XXXXXXXXXXXXXXXXXXXXXXXXXXXxXXXXXX-------------XXXXXXXXXXXXXXXX