----------------------------------------------------------------------------------------------------
----------------------------------------------------------------------------------------------------
----------------------------------------------------------------------------------------------------
----------------------------------------------------------------------------------------------------
------oo------------------------------------------------------------------------------------E-------
--------------------xxxxS-------SSS-----------------SSQSSS?SSS--------SSS------------------SQS--SQS-
-------------------xx--xxx-------------------------------------------------------xxxx---------------
------------------xx------x-xxx-------------------------------------------------xxXX-x--------------
-xxx-------------xx----E-EExx--xx-------------E-----------------------SSS------xxXXX--x-------------
xxE-x-------xxxxxxX--------XX-XX-x-----------<>-----SSSSSSSSSSS---------------xxXXXX---x---SQS--S?S-
x<>--x-----xxE--xXX--------XX-XX--x------------------------------------------xxXXXXX----x-----------
-[]---x---xx<>-XXXX--------XX-XXX--x--------------------------------xxxxx---xxXXXXXX-----x----------
-[]-E-Exxxx-[]-XXXX--------X--XXX--Exxxxxxxxxxxxxxxxxxxxxxxxxxxxxxxxx----xxxxXXXXXXX-----Exxxxxxxxxx
XXXXXXXXXXXXXXXXXXX--------X--XXXXXXXXXXXXXXXXXXXXXXXXXXXXXXXXXXXXXXX----XXXXXXXXXX--XXXXXXXXXXXXXXX