----------------------------------------------------------------------------------------------------
----------------------------------------------------------------------------------------------------
----------------------------------------------------------------------------------------------------
----------------------------------------------------------------------------------------------------
----------------------------------------------------------------------------------------------------
x----------------------------------------------------------------------------xxxxS-------SSS--------
-x--------------------------------------------------------------------------xx--xxx-----------------
--x------------------------------------------------------------------------xx------x-xxx------------
-----------------Q--?----------------E------------------------------------xx----E-EExx--xx----------
---x----------Q-E------ESSS----E----<>-------------------E--S------------xxX--------XX-XX-x---------
----x-----------E-------------<>------------------------<>---------E----xxXXX-------XX-XX--x--------
-----x------------------------------------xxxxx-------------------<>---xxXXXX-------XX-XXX--x-------
B---X-xxxxxxxxxxxxxxxxxxxxxxxxxxxxxxxxxxxxx----xxxxxxxxxxxxxxxxxxxxxxxxxXXXX--------X--XXX--Exxxxxxx
XXXXXXXXXXXXXXXXXXXXXXXXXXXXXXXXXXXXXXXXXXX---XXXXXXXXXXXXXXXXXXXXXXXXXXXXXX--------X--XXXXXXXXXXXXX