----------------------------------------------------------------------------------------------------
----------------------------------------------------------------------------------------------------
SSSSS--[]SSSSSSSSSSSSSSS------------------------------S---------------------------------------------
-------[]SSSSSSSSSSSSSSS-------------------XXXXXXXXX--S---------------------------------------------
-------[]SSSSSSSSSSSSSSS------------------XX----------S-----------------xxx--------------E----------
-------[]SSSSSSSSSSSSSSS-----------------XXX----------S--------------xxxx--x-----E-SSSSS---?--------
-------[]SSSSSSSSSSSSSSS----------------XXXX----------S-------------xxXXX---x-E---------------------
-------[]SSSSSSSSSSSSSSS---------------XXXXX----------S------------xx--------x----------------------
--------]SSSSSSSSSSSSSSS--------------XXXXXX----------S--------xxxxx----------x---------------------
xx-xxxx-]SSSSSSSSSSSSSSS--------E----XXXXXXX----------S-------xx-XXX-----------x----SSS-------------
>-xxSSSSSSSSSSSSSSSSSSSS-------<>---XXXXXXXX---<>-----S------xx-----------------x-------------------
SSSSSSSSSSSSSSSSSSSSSSSS--<>---[]--XXXXXXXXX---[]-----S-----xx-------------------x------------------
SSSSSSSSSSSSSSSSSSSSSSSS--[]---[]-XXXXXXXXXX---[]-----Sxxxxxx---------------------xxxxxxxxxxxxxxxxxx
XXXXXXXXXXXXXXXXXXXXXXXX--XX---XXXXXXXXXXXXXXXXXXXXXXXXxXXXXX---------------------XXXXXXXXXXXXXXXXXX