----------------------------------------------------------------------------------------------------
---------------------------------------------------------xx-----------------------------------------
--------------------------------------------------------xx-xxx------------SSSSSSSSSSSSSSSSSS--[]SSSS
-------------------------------------------------------xx--XX-x-------------[]------[]--------[]SSSS
-----------------------xxxxx--------------------------xx---XX--x------------[]---XXX[]--------[]SSSS
----------------------xxXXX-x------------------------SxS---XX---x-----------[]------[]--------[]SSSS
x--------------------xx-XXX--x------------------------x----XX----x----------<>------[]--------[]SSSS
-x------------------xx--XXX---x-------------------xxxxx----XX-----x-----------------[]--------[]SSSS
E-x----------------xxXX-XXX----x----------------xxx---x----XX------x----------------[]---------]SSSS
>--x--------------xxXXX-XXX-----x-------SSS----xx<>---SS---XX-------x---------------[]-xxxxxxx-]SSSS
]---x------------xxXXXX-XXX------x------------xx-[]--------XX--------x--------------<>xxSSSSSSSSSSSS
]----x----xxxxx-xxXXXXX-XXX-------xxx--------xx--[]--------XX---------x----xxx------xxx-SSSSSSSSSSSS
]-----xxxxx----xxXXXXXX-XXX-------XX-xxxxxxxxx---[]--------XX--------X-xxxxx--xxxxxxxE--SSSSSSSSSSSS
XXXXXXXXXXX---XXXXXXXX--XXXXXXXXXXXXXXXXXXXXXXXXXXXXXXXXXXXXXXXXXXXXXXXXXXXX--XXXXXXXX-XXXXXXXXXXXXX