----------------------------------------------------------------------------------------------------
----------------------------------------------------------------------------------------------------
------------------?---------------------------------------------------------------------------------
----------------------------------------------------------------------------------------------------
----------------------------------------------------------------------------------------------------
-----------------S----------------------------------SSSSSSSS----------------------------------------
----------------------------------------------------------------------------------------------------
----------------------------------------------------------------------------------------------------
------------xxxxxxxxx--------------------xxx----------xxxxxxx------------------------xxxxx-xxxxx-Exx
--xxx------xxXXXXXXX-x----xxxx----------xx--x-------xxxSSSSS-x----QQQQ-----------xxxxx----xx----xxx-
-xxX-x----xx----------x--xx---xxxxx----xx----x-----xx<>-------x-----------------xx-XXX---XXX----XXX-
xx-X--x--xx------------xxx----XXXX-x--xx------xxx-xx-[]--------x----E----------xx--XX----XX-----XX--
x--X---xxx--------------x-----------xxx-------XX-xx--[]---------xxxxxxxxxxxxxxxxX-------------------
XXXXXXXXXXXXX---------XXX-----------XXX-------XXXXXXXXXXXXXXXXXXXXXXXXXXXXXXXXXXX-------------------