----------------------------------------------------------------------------------------------------
----------------------------------------------------------------------------------------------------
----------------------------------------------------------------------------------------------------
----------------------------------------------------------------------------------------------------
-----------------------------------------E----------------------------------------------------------
---------------------------------------SSSSSSSS---SSSQ---------------?-----------SSS---SQQS----?QQQQ
xxxx------------------------------------------------------------------------------------------------
----x---------------------------------E-------------------------------------------------------------
-----xxx-------xxxx----S----------------------------------------------------------------------------
-----<>-x-----xx<>-x----------------S?S--------------S-----SS-----Q--Q--Q-----S---------SS-----SS-SS
-----[]--x---xx-[]--x-------------------------------------------------------------------------------
-----[]---x-xx--[]---x-----xxx--------------xxxxx------------------------------------------------E--
E----[]----xx-E-[]----xxxxxx--xxxxxxxxxxxxxxx----xxxxxxxxxxxxxxxxxxxxxxxxxxxxxxxxxxxxxxxxxxxxxxxxxxx
XXXXXXXXXXXXXXXXXXXXXXXXXXXX--XXXXXXXXXXXXXXX---XXXXXXXXXXXXXXXXXXXXXXXXXXXXXXXXXXXXXXXXXXXXXXXXXXXX