----------------------------------------------------------------------------------------------------
----------------------------------------------------------------------------------------------------
-?-----------------------------------------------------?--------------------------------------------
----------------------------------------------------------------------------------------------------
------------------xxxxx-------------------------------------------------xxxxx-----------------------
--------xxxxx----xxXX--x--------------------------------------xxxxx----xxXX--x----------------------
---SS--xx----x--xxXXX---x--------------------------------SS--xx----x--xxXXX---x---------------------
------xxX-----xxxXXXX----x----------------------------------xxX-----xxxXXXX----x--------------------
S----xxXX------xXXXXX-----x--------------------------SS----xxXX------xXXXXX-----x-------------------
----xxXXX------XXXXXX------x------------------------------xxXXX------XXXXXX------x------------------
---xxXXXX-----XXXXXXX-------x----------------------------xxXXXX-----XXXXXXX-------x-----------------
-xxxXXXXX----XXXXXXXX--------xx------------------------xxxXXXXX----XXXXXXXX--------xx---------------
xx-XXXXXX---XXXXXXXXX--------X-xxxxxxxxxxxxxxxxxxxxxxxxx-XXXXXX---XXXXXXXXX--------X-xxxxxxxxxxxxxxx
XX-XXXXXXXXXXXXXXXXXXXXXXXXXXXXXXXXXXXXXXXXXXXXXXXXXXXXX-XXXXXXXXXXXXXXXXXXXXXXXXXXXXXXXXXXXXXXXXXXX