----------------------------------------------------------------------------------------------------
----------xxx---------------------------------------------------------------------------------------
---------xx--x--------------------------------------------------------------------------------------
--------xx----xx------------------------------------------------------------------------------------
-------xx-----E-xxxxxx------------------------------------------------------------------------------
-----xxx---------x----x--------SSSSSS----------XXXXXXXXXXXXXXXX-------------QQQQQ------------SSSS---
----xx-S--------<>-----x---------------------------[]-------[]--------------------------------------
---xx-----------[]------xxxx--------xxx------------[]-------[]--------------------------------------
--xx------------[]-------xB-xxxxxxxxx--x-----------[]-------[]-------xxx-------------------------xxx
-xx-------X-----XX-------XXXXEXSSSSSS---x----------[]-------[]------xx<-x--E?QQQQ-----------S---xxXS
xxE---------------------XXXXXXX----------x---------<>-------<>-----xx-[]-x---------------------xx-X-
x<>--------------------XXXXXXXX-----------x--------xxx------xxx---xx--[]--x-------------------xx--X-
-[]-----X-------------XXXXXXXXX----------B-xxxxxxxxxE-xxxxxxxE-xxxx---[]---xxxxxxxxxxxxxxxxxxxx--EX-
XXXXXXXXX-------------XXXXXXXXXXXXXXXXEXXXXXXXXXXXXXX-XXXXXXXX-XXXXX--XXXXXXXXXXXXXXXXXXXXXXXXXXXXXX