----------------------------------------------------------------------------------------------------
-----------------------------------------------------------------------xxx--------------------------
------------------------------------------E---------------------------xx--x-------------------------
---------------------------------------------------------------------xx----xx-----------------------
--------------------------------------------------------------------xx-----E-xxxxxx-----------------
----------------------------------SSSSSSSS?S--------S----S--------xxx---------x----x-------SSSSSSS--
-----ES--------------E-------------[]----------------------------xx-S--------<>-----x---------------
-----------QQQ------<>-------------[]---------------------------xx-----------[]------xxxx--------xxx
--------------------[]-------------[]--------------xxxx--------xx------------[]-------xB-xxxxxxxxx--
-----------------QQQQQQQQQQ--------[]-------------xx<>-x------xx-------X-----XX-------XXXXESSSSSSS--
xx---------------------------------<>------------xx-[]--x----xxE---------------------XXXXXX---------
B-x----------xxxxx-----------------xxx----------xx--[]---x--xx<>--------------------XXXXXXX---------
---xxxxxxxxxxxB---xxxxxxxxxxxxxxxxxxE-xxxxxxxxxxx---[]----xxx-[]-----X-------------XXXXXXXX---------
XXXXXXXXXXXXXXX--XXXXXEEXXXXXXXXXXXXXXXXXXXXXXXXXXXXXXXXXXXXXXXXXXXXXX-------------XXXXXXXXXXXXXXXXE