----------------------------------------------------------------------------------------------------
---------------------------------------------------------xx-----------------------------------------
--------------------------------------------------------xx-xxx--------------------------------------
-------------------------------------------------------xx--XX-x-------------------------------------
------------------------------------------------------xx---XX--x------------------------------------
---------------------------------SSSSS---?-------xxx--xS---XX---x-----------------------------------
x-----------------------------------------------xx--x-x----XX----x----------------------------------
Ex---------------------------------------------xx----xx----XX-----x---------------------------------
>-x-------------------------------------------xx------x----XX------x--------------Q--?--------------
]--x------------------xxx-----S---E---------xxx-------SS---XX-------x----------Q-E------ESSS----E---
]---x----------------xxX-x-------------E---xx<>------------XX--------x-----------E-------------<>---
]----x-xxxxx-------Exx-X--x---------------xx-[]------------XX---------x-----------------------------
]-----xx----xxxxxxxxx--X---xxxxxxxxxxxxxxxx--[]E-----------XX--------X-xxxxxxxxxxxxxxxxxxxxxxxxxxxxx
XXXXXXXX---XXXXXXXXXX--XXXXXXXXXXXXXXXXXXXXXXXXXXXXXXXXXXXXXXXXXXXXXXXXXXXXXXXXXXXXXXXXXXXXXXXXXXXXX