---------------------------------------------------------------------------------xxx----------------
--------------------------------------------------------------------------------xx--x---------------
-------------------------------------------------------------------------------xx----x---SSSSSSSSSSS
[]-----------------------------------------------------------------------xxxxxxx------x--SSSS-------
[]----------------------------------------------------------------------xx----x--------x-SSSS-------
[]-------------------------------------------SSSSSSSSS-----SSSSS--------xX----E---------xSSSS-------
[]----------------xxxx--------------------------S-----------[]---------xx----<>----------x----------
[]---------------xx---xxx----------------------SS-----------[]---------x-----[]-----------x---------
[]--------------xx-----x-x--------------------SSS-------?---[]-------xxx-----[]-----------oxxx------
[]---------xxxxxx------S--xS-----------------SSSS-----------<>------xx<>-----[]----------S?SS-x----x
<>--------xxE--x-----------x---------------------------------------xx-[]-----[]----------SS----x--xx
[]-------xx<>-XX------------x------xxx------xxx----------xxx-E----xx--[]-----[]----------SS-----xxx-
xxxxxxxxxx-[]-XX-------------xxxxxxxE-xxxxxxxB-xxxxxxxxxxxB-xxxxxxx---[]-----[]------E-----E-EE--xX-
XXXXXEXXXXXXXXXX-------------XXXXXX<>XXXXXXXXXXXXXXXXXXXXXX-XXXXXXXEXXXX-----XXXXXXX<>XXXXX-XXXXXXX-