----------------------------------------------------------------------------------------------------
----------------------------------------------------------------------------------------------------
----------------------------------------------------------------------------------------------------
----------------------------------------------------------------------------------------------------
---E------------------------------------------------------------------------------------------------
SSSSSSS----------------------------------SSSSSS--------------xxxxx----------------------------------
---------------------------------------E--------------------xx-<>-x---------------------------------
----------------------------------------xxxxx--------------xx--[]--x--------------------------------
---E------X---------------------------xxx----xx----------xxx---[]---x----xxxx-------xxxx----S-------
---QQ?QQQQX--------------------------xx<>---<>-x--------xx<>--QQQ?---x--xx<>-x-----xx<>-x-----------
------------------------------------xx-[]---[]--x------xx-[]----------xxx-[]--x---xx-[]--x----------
x---------------xxx----------------xx--[]---[]---x----xx--[]-----------x--[]---x-xx--[]---x-----xxx-
-xxxxxxxxxxxxxxxx-Exxxxxxxxxxxxxxxxx---[]---[]----xxxxx---[]------E----B--[]----xx-E-[]----xxxxxx--x
XXXXXXXXXXXXXXXXX--XXXXXXXXXXXXXXXXXXXXXX---XX--XXXXXXXXXXXXX-----X---XXXXXXXXXXXXXXXXXXXXXXXXXXX--X