----------------------------------------------------------------------------------------------------
------------------------------------------xxxxxxxxxxxxxxxxxxxxxxxxxxxxxxxxxxxxxxxxxxxxxxxx----------
-SSSSSSSSSSSSSSSSSSSSSSSSSSSSSSSS--------xxSSSSSSSSSSSSSSSSSSSSSSSSSSSSSSSSSSSSSSSSSSSSSS-x---------
-SSS----------SSSSSSSSSS----------------xx-------------------------------------------------x--------
-SSS----------SSSSSSSSSS-----------XXX-xx---------------------------------------------------x-------
SSSS----------SSSSSSSSSS--QQ------xxxx-xSSS-----------E--------------------------------------x------
---------------------------------xx---xx-------------<>---------------------------------------x-----
-----------------------xxx-xxx--xx-----xS------------[]----------------------------------------x----
---X----------xxxxxxxxxx--xx--xxx------S-S-----------[]-------S----------------------E----------x---
S--X---------xx-SSSSSSSS--QQ--QQQ---------S-----E--SS[]SS---E----E------------------<>-----------x--
------------xx--SSSSSSSS-----------------------<>----[]----<>---<>---------------XX-[]--XXX-------x-
-ooxxxx----xx---SSSSSSSS-----------------------[]----[]----[]---[]--------------XXX-[]--XXX--------x
xxxx---xxxxx------SSSSSS-----------------------[]-E--[]----[]---[]----------E-E-XXX-[]--XXX-------X-
XXXX---XXXXX---XXXXXXXXXXXXXXXXXX------XXXXXXXXXXXXXXXXXXXXXXXXXXXXXXXXXXXXXXXXXXX--XX--XX------XXXX