----------------------------------------------------------------------------------------------------
-X--------------------------------------------------------------------------------------------------
SSSSSSSSSSSSSSSSSSSSSSSSSSSSSSSS?SSSSSSSSSSSSSSSSSSSSSSSSSSSSSSSSSSSSSSSSSSSSSSSS-------------------
SSS-------------------------------------------------------------------------------------------------
SSS--------------------------------------------------------------------------------XXX--------------
SSS--------------------------o-oo-----------------------------------------------------------------XX
---xxxxx-----------------------------------------xx-------------------------------------------------
--xx-->-x--------------------S-SS---------------xx-x-xxx--------------------------------------------
xxx---]--xxxxxxxxxxxxx------oSoS---------------xx---xx--x---------------------xxxxx-----SSSSS??-----
SSS--QQ?SS?SSSSS?????-xx----SSSS-------------xxx----<>---x------xxxx---------xxXXX-xxxx-------------
SSS-------SSSSSSSSSSS<>-x-------------------xx<>----[]----xxx--xxSS-x-------xxEXXX-XXX-x------------
SSS-------SSSSSSSSSSS[]--x-----------------xx-[]----[]----<>-xxx-SS--x-----xxXXXXX------x------xxx--
SSS------------------[]---xxxxxxxxxxxxxxxxxx--[]----[]--E-[]--x--SS---xxxxxxXXXXXX-------xxxxxxx--xx
XXXXXXXXXXXX-XX-XXXXXXXXXXXXXXXXXXXXXXXXXXXXXXXXXXXXXXXXXXXXXXX--XX--XXXXXXXXXXXX-------XXXXXXXX--XX