----------------------------------------------------------------------------------------------------
----------------------------------------------------------------------------------------------------
----------------SSSSSSSSSSSSSSSSSSSSSSSSSSSSSSSSSSSSSSSSSSSSSSSSSSSSSSSSSSSSSSSSSSSSSSSSSSSSSSSSSSSS
------------------[]----[]-------------------------------------------------------SSSSSSSSSSS-SSSSSSS
------------------[]----[]-------E-----------------------xxx---------------------SSSSSSSSSSS?SSSSSSS
---xx-------------[]----[]---QQQQQQ--------------E-xxxxxxx--x--------------------SSSSSSSSSSS?SSSSSSS
--xx-x------------<>----[]------------------------xxSSSSSS---xxxxx----------------------------------
-xx---x-----------------[]---------------oo------xx-SSSSSS--SSSSS-x--------------------------xxxx---
xx-----x----------------[]--xxxxxxxxxxxxxxxxxxxxxx--SSSSSS--SSSSS--xxxxxxxxxxxxxxxxxxxxxxxxxxx---xxx
x-------x---------------[]-xxSSSSSSSSSSSSSSSSSSSSS--SSSSSS--SSSSS?SS?SSSSS???????SSSSSSSSSSSS?---SSS
---------x--------------<>xx-SSSSSSSSSSSSSSSSSSSSS------------------SSSSSSSSSSSSS-------------------
----------x------xxx-----xx--SSSSSSSSSSSSSSSSSSSSS--------<>--------SSSSSSSSSSSSS-------------<>----
X--------X-xxxxxxx--xxxxxx---SSSSSSSSSSSSSSSSSSSSS--------[]----------------------------------[]----
XXXXXXXXXXXXXXXXXX--XXXXXXE--XXXXXXXXXXXXXXXXXXXXXXXXXXXXXXXXXXXXXXXXX-XX-XXXXXXXXXXXXXXXXXXXXXXXXXX