----------------------------------------------------------------------------------------------------
----------------------------------------------------------------------------------------------------
----------------------------------------------------------------------------------------------------
----------------------------------------------------------------------------------------------------
--oo-----------------------------------------xxxxxxxxxx---------------------------------------------
---------------------------------------------xSSSSSSSS-x--------------------------------------------
---------------------------------------------x----------x-------------------------------------------
---------------------------------------------x-----------x------------------------------------------
--------------------------------------------xx------------x-----------------SSSSSSS--?--------------
x-----------------------------xxxx---------xxX----S----X---x----------------------------------------
-x-----xxxx------------------xx<>-x-------xx-X------E--X----x--E------------------------------------
--x---xx<>-x----------------xx-[]--x-----xx--X---------X-----xxxxxxxxxxx--------------xxxxxx------Ex
E-Exxxx-[]-Exxxxxxxxxxxxxxxxx--[]---xxxxxxE--X---------X------x----x----xxxxxxxxxxxxxxx--x--xxxxxxxx
XXXXXXXXXXXXXXXXXXXXXXXXXXXXXXXXXXXXXXXXXXXXXXXXXXXXXXXXXXXXX-X-XX-X-XX-XXXXXXXXXXXXXXX--X--XXXXXXXX