----------------------------------------------------------------------------------------------------
----------------------------------------------------------------------------------------------------
----------------------------------------------------------------------------------------------------
----------------------------------------------------------------------------------------------------
----------------------------------------------------------------------------------------------------
----------xx-----------------------------------------------------------XXX--------------------------
---------xx-x---------------------------------S-----------------------------------------------------
--------xx---x----oooooo----------------------------------------------------------------------------
----xxxxx-----x-----xx---------------------------------------ooo----------------------xxxxx-xxxxx-Ex
---xx--XX------x---xx-x----------------------------------------------E------------xxxxx----xx----xxx
--xx---XXX------x-xx---x-----------E------xxxxxx---------------------------------xx-XXX---XXX----XXX
xxx----XXXX------xx-----xxx--------------xx---X-x-------------------------------xx--XX----XX-----XX-
-xX----XXXXX-----<>-----XX-xxxxxxxxxxxxxxxX---X--xxxxxxxxxxxxxxxxxxxxxxxxxxxxxxxxX------------------
XXX----XXXXXX----[]------XXXXXXXXXXXXXXXXXX---X--XXXXXXXXXXXXXXXXXXXXXXXXXXXXXXXXX------------------