----------------------------------------------------------------------------------------------------
---------------------------------------------------------------------------xxx----------------------
----------------------------------------------E---------------------------xx--x---------------------
-------------------------------------------------------------------------xx----xx-------------------
------------------------------------------------------------------------xx-----E-xxxxx---------xxxxx
--------------------------------------SSSSSSSS?S--------S----S--------xxx---------x---x-----xxxx--X-
---------ES---------------E------------[]----------------------------xx-S--------<>----x---xx--E--X-
-----------------QQ------<>------------[]---------------------------xx-----------[]-----x-xx---XX-X-
-------------------------[]------------[]--------------xxxx--------xx------------[]------xx----XX-X-
----------------------QQQQQQQQQQ-------[]-------------xx<>-x------xx-------X-----XX------<>----XX-X-
---xxx---------------------------------<>------------xx-[]--x----xxE---------------------[]----XX-X-
x-xxB-x-----------xxxxx----------------xxx----------xx--[]---x--xx<>---------------------[]----XX-X-
-xx-b--xxxxxxxxxxxxB---xxxxxxxxxxxxxxxxxE-xxxxxxxxxxx---[]----xxx-[]-----X---------------[]----XX-X-
XXXXXXXXXXXXXXXXXXXX--XXXXXEEXXXXXXXXXXXXXXXXXXXXXXXXXXXXXXXXXXXXXXXXXXXXX---------------XX-XXXXX-XX