----------------------------------------------------------------------------------------------------
----------------------------------------------------------------------------------------------------
-----------------------------------------------------------------------------SSSSSSSSSSSSSSSSSSSSSSS
-------------------------------------------------------------------------------[]]---[]-------------
-------------------------------------------------------------------------------[]]---[]-------E-----
------------------SSSSSSS----------XXXXXXXXXXXXXXX--------------X--------------[]>---[]---QQQQQQ----
-------------xx------------------------[]------[]------------------------------<>----[]-------------
-------------xBx--------xxx------------[]------[]-------------X----------------------[]-------------
---xxx------xxb-xxxxxxxxx--x-----------[]------[]-------xxx--------------------------[]--xxxxxxxxxxx
S-xx--x----xxXXXXESSSSSSS---x----------[]------[]------xx<-x-------------------------[]-xxSSSSSSSSSS
-xx----x--xxXXXXXX-----------x---------<>------<>-----xx-[]-x------------------------<>xx-SSSSSSSSSS
xx------xxxXXXXXXX------------x--------xxx-----xxx---xx--[]--x----------xx----xxx-----xx--SSSSSSSSSS
x--------xXXXXXXXX-----------B-xxxxxxxxxE-xxxxxxE-xxxx---[]---xxxxxxxxxxxXxxxxx--xxxxxx---SSSSSSSSSS
X--------XXXXXXXXXXXXXXXXXEXXXXXXXXXXXXXX-XXXXXXX-XXXXX--XXXXXXXXXXXXXXXXXXXXXX--XXXXXXE--XXXXXXXXXX