----------------------------------------------------------------------------------------------------
----------------------------------------------------------------------------------------------------
----------------------------------------------------------------------------------------------------
----------------------------------------------------------------------------------------------------
----------------------------------------------------------------------------------------------------
----------------------------------------------------------------------------------------------xx----
---------------------------------------------------------------------------------------------xx-x---
---------------------------------------------------------xx---------------------------------xx---x--
----------------------------------------------ooo-------xx-x---------oooo---------------xxxxx-----x-
xxxxx---------------------xxx----------------------xxxxxx---xxx---------------E--------xx--XX------x
x--<>x-------------------xxX-x--------------------xx---x----<>-x------------------E---xx---XXX------
X--[]-x-----xxxx-xxx----xx-X--x------------------xx----X----[]--x--------------------xx----XXXX-----
Q--[]--xxxxxx---xx--xxxxx--X---xxxxxxxxxxxxxxxxxxx-----XX---[]---xxxxxxxxxxxxxxxxxxxxxX----XXXXX----
XXXXXXXXXXXXX--XXX--XXXXXXXX--XXXXXXXXXXXXXXXXXXXX-----XXX--[]XXXXXXXXXXXXXXXXXXXXXXXXX----XXXXXX---