----------------------------------------------------------------------------------------------------
----------------------------------------------------------------------------------------------------
SSSSSSSSSSSSSSSSSSSSSSSSSSSSSSSSSSSSSSSSSSSSSSSSSSSSSSSSSSSSSSSSSSSSSSSSSSSSSSSSSSSSSSSSSSSSSSSSSSSS
-------[]----[]-------------------------------------------------SSSSSSSSSSSSSSSSSSSSSSSSSSSSSSSSS---
-------[]----[]-------E----------------xxx----------------------SSSSSSSSSSSSSSSSSSSSSSSSSSSSSSSSS---
-------[]----[]---QQQQQQ--------xxxxxxxx--x---------------------SSSSSSSSSSSSSSSSSSSSSSSSSSSSSSSSS---
-------<>----[]----------------xxSSSSSSS---xxxxx----------------------------------------------------
-------------[]---------------xx-SSSSSSS--SSSSS-x----------------------------------xxxxx-------xxxxx
xx-----------[]--xxxxxxxxxxxxxx--SSSSSSS--SSSSS--xxxxxxxxxxxxxxxxxxxxxxxxxxxxxxxxxxx----xxxxxxxxE--<
>-x----------[]-xxSSSSSSSSSSSSS--SSSSSSS--SSSSS?SS?SSSSS????????SSSSSSSSS???SSSSSXS?----SSSSSSSSS--[
]--x---------<>xx-SSSSSSSSSSSSS-------------------SSSSSSSSSSSSSS-----------------------------------[
]---x-xxx-----xx--SSSSSSSSSSSSS---------<>--------SSSSSSSSSSSSSS---------------------<>------------[
]----xx--xxxxxx---SSSSSSSSSSSSS---------[]-------------------------------------------[]------------[
XXXXXXX--XXXXXXE--XXXXXXXXXXXXXXXXXXXXXXXXXXXXXXXXXX-XX-XXXXXXXXXXXXXXXXXXXXXXXXXXXXXXXXXXXXXXXXXXXX