----------------------------------------------------------------------------------------------------
----------------------------------------------------------------------------------------------------
----------------------------------------------------------------------------------------------------
----------------------------------------------------------------------------------------------------
------------------------------------------------E----------------------xxxxxxxxxxx----------E-E-----
--------------------------------------------SSSSSS----S---------------xx--QQQ?QQQ-x-------SSSSSSS-SS
---------------------------------------------------------------------xx------------x-------------E--
-------------------------B------------------------------------------xx------E-------x--------------x
-------------------------b-------------------E--------------------xxx-----SSSSSSS----x-----------xxx
QQQQ-------------------SSXSS-------xxxxx---SSSSSSS---xxxx--------xx<>--------------E--x---------xx<>
-------B-----E---B----------------xx-<>-x-----------xx<>-x------xx-[]-------X------X---x---E---xx-[]
E------b---------b-----------B---xx--[]--x---------xx-[]--x----xx--[]-------X------X----x-----xx--[]
xxxxxxxxxxxxxxxxxxxxxxxxxxxxxxxxxx---[]---xxxxxxxxxx--[]---xxxxx---[]----E--X------X-----xxxxxx---[]
XXXXXXXXXXXXXXXXXXXXXXXXXXXXXXXXXX--XXXXXXXXXXXXXXXXXXXXXXXXXXXXXXXXXXXXXXXXXXXXXXXXXXXXXXXXXXXXXXXX