----------------------------------------------------------------------------------------------------
----------------------------------------------------------------------------------------------------
----------------------------------------------------------------------------------------------------
-----------------------------------------------------------------------------------------xxx--------
--------------------------------------------------------------------------------------xxxx--x-------
X-----------------------QQQ?QQQQQQQQQ?QQQQ--------------E------E---------------------xx-XX---x-----S
]--------------------------------------[]------------E------------------------------xx--------x----S
]--------------------------------------[]--------xxxxxxxxxxxxxxx----------------xxxxx----------x----
]--------------------------------------[]-------xxXSSSSSSSSSSSS-x-------------xxx--<>-----------x--S
>SSSSSS-------------------SSSSSSSSSSSS-<>------xxXX--------------x--------QQ-xx<>--[]------------x-S
----------------------------------------------xxXXX----oooooo-----x---------xx-[]--[]-------------xS
Exxx---------------------E---E---------xxx---xxXXXX----------------xxxx----xx--[]--[]---------------
xxE-xxxxxxxxxxxxxxxxxxxxxxxxxxxxxxxxxxxxE-xxxxXXXXX----oooooo-------x--xxxxx---[]--[]-------------X-
X<>XXXXXXXXXXXXXXXXXXXXXXXXXXXXXXXXXXXX<>-XXXXXXXXXXXXXXXXXXXXX-----X--XXXXX--XXX--XXXXXXXX-------XX