----------------------------------------------------------------------------------------------------
----------------------------------------------------------------------------------------------------
----------------------------------------------------------------------------------------------------
----------------o-----------------------------------------------------------------------------------
--------ooooooooSooo--------------------------------------------------------------------------------
------SSSSSSSSSSSSSSSS---------------------------xx-------------------------------------------------
------------------------------------------------xx-x------------------------------------------------
---------xxxxxxxxx-----------------------------xx---x----oooooo-------------------------------------
<->--xxxxx---x-<>-x------------------------xxxxx-----x-----xx---------------------------------------
[-]-xx--?S---?-[]--x----------------------xx--XX------x---xx-x--------------------------------------
---xx----------[]---x----------E----E----xx---XXX------x-xx---x-----------E-------------------------
-xxx-----------[]----x------------------xx----XXXX------xx-----xxx---------------xxxxxx-------------
xxx------------[]----ExxxxxxxxxxxxxxxxxxxX----XXXXX-----<>-----XX-xxxxxxxxxxxxxxxxE-EE-xxxxxxxxxxxxx
XXX---XXXXXXXXXXXXXXXXXXXXXXXXXXXXXXXXXXXX----XXXXXX----[]------XXXXXXXXXXXXXXXXXXXXXXXXXXXXXXXXXXXX