----------------------------------------------------------------------------------------------------
----------------------------------------------------------------------------------------------------
----------------------------------------------------------------------------------------------------
----------------------------------------------------------------------------------------------------
----------------------------------------------------------------------------------------------------
-------------------------------------------------------------------------------xxx------------------
------------------------------------------------------------------------------xxX-x-----------------
-----------------------------------------------------------------------------xxXX--x--------------xx
---------S----------------xxxx--------------------------xx------------------xxXXX---x----------xxxx-
----------------xxx------xx<>-x------------------xxxx--xx-x----------------xxXXXX----x--------xxQQ?-
xxx-----xxx----xxX-x----xx-[]--x----QQQQQQ?-----xx---xxx---x--------------xxXXXXX-----x------xx-----
<>-x---xxS-x--xx-X--x--xx--[]---x--------------xx-----x-----xx-----------xxXXXXXX------x----xx------
[]--xxxx-S--xxx--X---xxx---[]----xxxxxxxxxxxxxxxX-----X-----X-xxxxxxxxxxxxXXXXXXX-------xxxxx--X----
XXXXXXXXXXXXXXXXXXXXXXXXXXXXXXXXXXXXXXXXXXXXXXXXX-----X-----XXXXXXXXXXXXXXXXXXXXXXXXXXXXXXXXXXXXXXXX