----------------------------------------------------------------------------------------------------
----------------------------------------------------------------------------xxxxxxxxxxxxxxxxxxxxxxxx
SSSSSSSSSSSSSSSSSSSSSSSSSSSSSSSSSSSSSSSSSSSSSSSSSSSSSSSSSSSSSSSSSSS--------xxSSSSSSSSSSSSSSSSSSSSSSS
]----------SSSSSSSSSSSSSSSSSSSSSSSSSSSSSSSSSSSSSSSSSSSSSSSSSSSSSSSS-------xx------------------------
]----------SSSSSSSSSSSSSSSSSSSSSSSSSSSSSSSSSSSSSSSSSSSSSSSSSSSSSSSS--XXX-xx-------------------------
]----------SSSSSSSSSSSSSSSSSSSSSSSSSSSSSSSSSSSSSSSSSSSSSSSSSSSSSSSS-xxxx-xSSS-----------E-----------
]------------------------------------------------------------------xx---xx-------------<>-----------
------------------xxx---------------------------------xxxxx-------xx-----xS------------[]-----------
-----------xxxxxxxx?-xxxxxxxxxxxxxxxxxxxxxxxxxxxxxxxxxx----xxxxxxxx------S-S-----------[]-------S---
----------xx-SSSSSS??SSSSSSSSSSSSS??????????SSSSSSSSSS?----SSSSSSSQ---------S-----E--SS[]SS---E---E-
---------xx--SSSSS---SSSSSSSSSSSSSSSSSSSSSSS-------------------------------------<>----[]----<>--<>-
-xxxxxx-xx---SSSSS---SSSSSSSSSSSSSSSSSSSSSSS------------<>-----------------------[]----[]----[]--[]-
xx--x--xx---------oooSSSSSSSSSSSSSSSSSSSSSSS------------[]-----------------------[]-E--[]----[]--[]-
XX--X--XX---XXXXXXXXXXXXXXXXXXXXXXXXXXXXXXXXXXXXXXXXXXXXXXXXXXXXXXX------XXXXXXXXXXXXXXXXXXXXXXXXXXX