----------------------------------------------------------------------------------------------------
----------------------------------------------------------------------------------------------------
----------------------------------------------------------------------------------------------------
----------------------------------------------------------------------------------------------------
----------------------------------------------------------------------------------------------------
-----------------------------------------------------xxx--------------------------------------------
----------------------------------------------------xxX-x-------------------------------------------
---------------------------------------------------xxXX--x--------------xxxxx-----------------------
xxx---------------------------xx------------------xxXXX---x----------xxxx-<>-x------------------Q?--
<>-x-------------------xxxx--xx-x----------------xxXXXX----x--------xxQQ?-[]--x---------------------
[]--x----QQQQQQQ?-----xx---xxx---x--------------xxXXXXX-----x------xx-----[]---x--------------------
[]---x---------------xx-----x-----xx-----------xxXXXXXX------x----xx------[]----x----------------xxx
X]----xxxxxxxxxxxxxxxxX-----X-----X-xxxxxxxxxxxxXXXXXXX-------xxxxx--X----[]-----xxxxxxxxxxxxxxxxx--
XXXXXXXXXXXXXXXXXXXXXXX-----X-----XXXXXXXXXXXXXXXXXXXXXXXXXXXXXXXXXXXXXXXXXXXXXXXXXXXXXXXXXXXXXXXX--