----------------------------------------------------------------------------------------------------
xxxxxxx---------------------------------------------------------------------------------------------
SSSSSSS---------------------------------------------------------------------------------------------
----------------------------------------------------------------------------------------------------
----------------------------------------------------------------------------------------------------
--------------------------------------------------------------------------------SSSSSSS-------------
-----------------------------------------xx---------------------------------------------------------
----------------------------------------xx-x---------------------------------------------------xxxxx
---------------------------------------xx---x------------------------------------E--E---------xxXSS-
-------------------------------------xxx-----xxx--------------------------------SSSSSSS------xxXX---
->---SS-----------------------------xx<>-----<>-x--E-------------------Q?QQQ----------------xxXXX---
o]---SS----------------------------xx-[]-----[]--x---------------------------------xxx-----xxXXXX---
[]---SSxxxxxxxxxxxxxxxxxxxxxxxxxxxxx--[]-----[]---xxxxxxxxxxxxxxxxxxxxxxxxxxxxxxxxxx--xxxxxxXXXXX---
XX---XXXXXXXXXXXXXXXXXXXXXXXXXXXXXXXXXXXXXX--XXXXXXXXXXXXXXXXXXXXXXXXXXXXXXXXXXXXXXX--XXXXXXXXXXXXXX