----------------------------------------------------------------------------------------------------
xxxxxxxxxxxxxxxxxx----------------------------------------------------------------------------------
SSSSSSSSSSSSSSSSSS----------------------------------------------------------------------------------
--------------[]------------------------------------------------------------------------------------
--------------[]-------------------------------------------------------x----------------------------
--------------[]-------------------------------------------------------xxxx------------------XX-----
--------------[]----------X--EX----------------------------------------x<>-x-----------------[]-----
--------------<>----------X---X----------------------------------------x[]--x----------------[]-----
--------------------X---X-X---X--------X-EE----X-----------------E----xx[]---x----xxxx-------[]-----
-------<>-----------XSSSX-XSS?X--------XSSSSSSSX---------------------xxS[]----x--xx---xx-----<>SSSSS
-------[]----S-S-S-------------------------------------------oo-----xx--[]-----xxx----X-x-----------
oooo---[]----S-S-S-----------------xxx-----------------------oo----xx---[]------x-----XX-xx---Exxx--
oooo---[]----S-S-Sxxxxxxxxxxxxxxxxxx--xxxxxxxxxxxxxxxxxxxxxxxxxxxxxx----[]------B-----XXXX-xxxxxE-xx
XXXX---[]----S-S-SXXXXXXXXXXXXXXXXXX--XXXXXXXXXXXXEEXEXXXXXXXXXXXXXXXXXXXXXXXXXXX-----XXXXXXXXX<>XXX