----------------------------------------------------------------------------------------------------
----------------------------------------------------------------------------------------------------
----------------------------------------------------------------------------------------------------
----------------------------------------------------------------------------------------------------
----------------------------------------------------------------------------------------------------
---------------------------------------xxxx------------------XX----SS-------------------------SSSSS-
---------------------------------------x<>-x-----------------[]-------------------------------------
---------------------------------------x[]--x----------------[]-------------------------------------
X-------------ooo----------------E----xx[]---x----xxxx-------[]--------------------------------E----
X-------------ooo--------------------xxS[]----x--xx---xx-----<>SSSSSS------------------------SSSSSS-
-----------------------------oo-----xx--[]-----xxx----X-x------------------------------xxxx--------x
-----------------------------oo----xx---[]------x-----XX-xx---Exxx----------------B---xx<>-x------xx
xxxxxxxxxxxxxxxxxxxxxxxxxxxxxxxxxxxx----[]------B-----XXXX-xxxxxE-xxxxxxxxxxxxxxxxxxxxx-[]--xxxxxxx-
XXXEEXEXXXXXXXXXXXXEEXEXXXXXXXXXXXXXXXXXXXXXXXXXX-----XXXXXXXXX<>XXXXXXXXXXXXXXXXXXXXXXXXXXXXXXXXXXX