----------------------------------------------------------------------------------------------------
----------------------------------------------------------------------------------------------------
----------------------------------------------------------------------------------------------------
----------------------------------------------------------------------------------------------------
----------------------------------------------------------------------------------------------------
QQ--------------------------------------------------------------------------------------------------
-----------------------xxx--------------------------------------------------------------------------
----------------------xxX-x-------------------------------------------------------------------------
---------------------xxXX--xo------o----o-------------------oo---oo---------------------------------
QQQQ----------------xxXXX---x------------------xxxxx-------xx-----------------------------xxxx------
-------------------xxXXXX----x----------------xx----x-----xx-x---------------------------xx<>-x-----
------------------xxXXXXX-----x--xxxxxxxxxx--xxX---X-x---xx---xxxxxx--------------------xx-[]--x----
xxxxxxxxxxxxxxxxxxxXXXXXX------xxx----x----xxx-X-E-X--xxxx-----x----xxxxxxxxxxxxxxxxxxxxx--[]---xxxx
XXXXXXXXXXXXXXXXXXXXXXXXXXXXXXXXXX---XX---XXXXXXXXXXXXXXXX-----X----XXXXXXXXXXXXXXXXXXXXXXXXXXXXXXXX