----------------------------------------------------------------------------------------------------
----------------------------------------------------------------------------------------------------
----------------------------------------------------------------------------------------------------
----------------------------------------------------------------------------------------------------
----------------------------------------------------------------------------------------------------
---------------------------------SSSSSS--------------xxxxx--------------------------xxxxS-------SSS-
-------------------------------E--------------------xx-<>-x------------------------xx--xxx----------
--------------------------------xxxxx--------------xx--[]--x----------------------xx------x-xxx-----
--X---------------------------xxx----xx----------xxx---[]---x--------------------xx----E-EExx--xx---
QQX--------------------------xx<>---<>-x--------xx<>--QQQ?---x------------------xxX--------XX-XX-x--
----------------------------xx-[]---[]--x------xx-[]----------x-------xxxx-----xxXXX-------XX-XX--x-
--------xxx----------------xx--[]---[]---x----xx--[]-----------x-----xx<>-x---xxXXXX-------XX-XXX--x
xxxxxxxxx-Exxxxxxxxxxxxxxxxx---[]---[]----xxxxx---[]------E-----xxxxxx-[]--xxxxXXXX--------X--XXX--E
XXXXXXXXX--XXXXXXXXXXXXXXXXXXXXXX---XX--XXXXXXXXXXXXXX----X---XXXXXXXXXXXXXXXXXXXXX--------X--XXXXXX