----------------------------------------------------------------------------------------------------
----------------------------------------------------------------------------------------------------
---------------------------------------------------------------------------------------------------E
----------------------------------------------------------------------------------------------------
--------------------------------------------------------------------------------------xxxx----------
----------------------------------SSSSSS--------------xxxxx--------------------------xxXX-x---------
--------------------------------E--------------------xx-<>-x------------------------xxXXX--x--------
---------------------------------xxxxx--------------xx--[]--x----------------------xxXXXX---x-------
-X-----------------------------xxx----xx----------xxx---[]---x--------------------xxXXXXX----x------
QX----------------------------xx<>---<>-x--------xx<>--QQQ?---x------------------xxXXXXXX-----x-----
-----------------------------xx-[]---[]--x------xx-[]----------x-------xxxx-----xxXXXXXXX------x----
--------xxx-----------------xx--[]---[]---x----xx--[]-----------x-----xx<>-x---xxXXXXXXXX-------x---
xxxxxxxxx-Exxxxxxxxxxxxxxxxxx---[]---[]----xxxxx---[]------E-----xxxxxx-[]--xxxxXXXXXXXXX--------xxx
XXXXXXXXX--XXXXXXXXXXXXXXXXXXXXXXX---XX--XXXXXXXXXXXXX-----X---XXXXXXXXXXXXXXXXXXXXXXXXXXXXXXXXXXXXX