----------------------------------------------------------------------------------------------xxx---
---------------------------------------------------------------------------------------------xx--x--
--------------------------------------------------------------------------------------------xx----x-
-------------------------------------------------------------------------------------------xx------x
xxxxxxxxxxxx----------E-E------------------xxxxx-----------------------------------------xxx--------
x---QQQ?QQQ-x-------SSSSSSS-SS-xxxx-----xxxx--X-x-------------------SS------------------xxXX--------
x------------x-------------E--xx---x---xx--E--X--x-------------------------------------xxXXX--------
x-----E-------x--------------xx-----x-xx---XX-X---x-----------------------------------xxXXXX--------
Q---SSSSSSS----x-----------xxx-------xx----XX-X----x---------------xxx---------------xxXXXXX--------
-------------E--x---------xx<>-------<>----XX-X-----x-------------xx--x-------------xxXXXXXXS-------
------X------X---x---E---xx-[]-------[]----XX-X------x-----S-----xx----x-----------xxXXXXXXX--------
------X------X----x-----xx--[]-------[]----XX-X-------S---------xx------xx--------xxXXXXXXXX--------
---E--X------X-----xxxxxx---[]-------[]----XX-X-------xxxxxxxxxxx------XX-xxxxxxxxxXXXXXXXXX--------
XXXXXXXXXXXXXXXXXXXXXXXXXXXXXX-------XX-XXXXX-XXXXXXXXXXXXXXXXXXX------XXXXXXXXXXXXXXXXXXXXXXX------