----------------------------------------------------------------------------------------------------
xxxxxxxxxxxxxxxxxxxxxxx-----------------------------------------------------------------------------
SSSSSSSSSSSSSSSSSSSSSSS-----------------------------------------------------------------------------
SSSSSSSSSSSS----------------------------------------------------------------------------------------
SSSSSSSSSSSS----------------------------------------------------------------------------------------
SSSSSSSSSSSS-----E----------------------------------------------------------------------------EXX---
----------------<>---------------------------------------------------------------------------EXXX---
----------------[]-------------------------------------------------------------E------------EXXXX---
?ooooooo--------[]---------------------------------xxx--------------------------XXX------X--XXXXX---
??SSSSSS----XX--[]-----------------------------E--xxX-x------------------------------------XXXXXX---
-----------XXX--[]---SS------------------------E-xx-X--x---xxxx---------------------------XXXXXXX---
----------XXXX--[]---SS-------------------------xx--X---x-xx<>-x-------------------------XXXXXXXX---
---E-E---XXXXX--[]---SSxxxxxxxxxxxxxxxxxxxxxxxxxx---X----xx-[]--xxxxxxxxxxxxxxx---------XXXXXXXXX---
XXXXXXXXXXXXXXXXXXX--XXXXXXXXXXXXXXXXXXXXXXXXXXXXXXXXXXXXXXXXX--XXXXXXXXXXXXXXX--------XXXXXXXXXXXXX