--xxx--------xxx--------xxx-------------------------------------------------------------------------
-xx--x------xx--x------xx--x------------------------------------------------------------------------
xx----x----xx----x----xx----x--------------xxxx--?--------------------------------------------------
x------x--xx------x--xx------x-ooxxx------xx---x---xxx------xx--------------------------------------
--------xxx--------xxx--------xxxx--x----xx-----xxxx--x----xx-x--------xxx--------------------------
--------XXX--------XXX--------XXXX---x--xx------XXXX--ox--xx---x------xx--x-------xx----------------
--------------------------------------xxx-------------o-xxx-----x----xx----x-----xx-x------xxxx----x
----oo--------------------------------XXX---------------XXX------x--xx------x---xx---x----xx---x--xx
----SS------------------------------------------------------------xxx--------xxxx-----x--xx-----xxx-
------------------------------------------------------------------XXXEXX-----XXXX------xxx------XXX-
------------------------E-----E--------------------------------------------E-----------XXX-----E----
-----------------------<>----<>---------------------XXX---------------------------------------<>----
o----------------------[]----[]---------------------------------------------------------------[]----
X-------------XXX-----X[]X--X[]XXXXX-------XXEX--------------XXXXX----------------------------[]----