----------------------------------------------------------------------------------------------------
----------------------------------------------------------------------------------------------------
----------------------------------------------------------------------------------------------------
----------------------------------------------------------------------------------------------------
-------------------xxx--------oo--------------------------------------------------------------------
--S---------------xx--x----------------------------------------SSSSSS--------------xxxxx------------
-----------------xx----x-------------------------------------E--------------------xx-<>-x-----------
----------------xx------x-------------------------------------xxxxx--------------xx--[]--x----------
--------------xxx--o-----xxx--------------------------------xxx----xx----------xxx---[]---x---------
-xxxx--------xx<>--------<>-x-------------------------------x<>---<>-x--------xx<>--QQQ?---x--------
xx<>-x------xx-[]--------[]--x-----xxxx--------------------xx[]---[]--x------xx-[]----------x-------
x-[]--x----xx--[]--------[]---x---xx<>-x------------------xx-[]---[]---x----xx--[]-----------x-----x
--[]---xxxxx---[]--------[]-E-Exxxx-[]-Exxxxxxxxxxxxxxxxxxx--[]---[]----xxxxx---[]------E-----xxxxxx
XXXXXXXXXXXXXXXXXXXXXXXXXXXXXXXXXXXXXXXXXXXXXXXXXXXXXXXXXXXXXXX---XX--XXXXXXXXXXXXX-----X---XXXXXXXX