----------------------------------------------------------------------------------------------------
----------------------------------------------------------------------------------------------------
----------------------------------------------------------------------------------------------------
----------------------------------------------------------------------------------------------------
----------------------------------------------------------------------------------------------------
--------------------------------------------------------------QQQQQ---------------------------------
---xxx--------------ES--------------E---------------------------------------------------------------
---xB-x------S------------QQQ------<>---------------------------------------------------------------
--xxb------------------------------[]-----------------xxxx------------------------------------E-----
-xxXXX-xS-----------------------QQQQQQQQQQ-----------xx<>-x--E?QQQQ------------------SSQS----<>-----
xxXXXX--x-----xxx-----------------------------------xx-[]--x---------------------------------[------
xXXXXX---x---xxB-x----------xxxxx------------------xx--[]---x-------------xxxxx---------------------
XXXXXX----xxxx-b--xxxxxxxxxxxB---xxxxxxxxxxxxxxxxxxx---[]----xxxxxxxxxxxxxx----xxxxxxxxxxxxxxxxxxxxx
XXXXXXXXXXXXXXXXXXXXXXXXXXXXXX--XXXXXEEXXXXXXXXXXXXXXXXXXXXXXXXXXXXXXXXXXXX---XXXXXXXXXXXXXXXXXXXXXX