----------------------------------------------------------------------------------------------------
----------------------------------------------------------------------------------------------------
----------------------------------------------------------------------------------------------------
----------------------------------------------------------------------------------------------------
----------------------------------------------------------------------------------------------------
-------------------------------------------------------------------------------xx-------------------
------------------------------------------------------------------------------xx-x------------------
--------------------------------------xx-------------------------------------xx---x----oooooo-------
---------------------------ooo-------xx-x---------oooo-------------------xxxxx-----x-----xx---------
E-xxxx--------------------------xxxxxx---xxx----------------------------xx--XX------x---xx-x--------
-xx<>-x------------------------xx---x----<>-x--------------E------E----xx---XXX------x-xx---x-------
xx-[]--x----------------------xx----X----[]--x------------------------xx----XXXX------xx-----xxx----
x--[]---xxxxxxxxxxxxxxxxxxxxxxx-----XX---[]---xxxxxxxxxxxxxxxxxxxxxxxxxX----XXXXX-----<>-----XX-xxxx
XXXXXXXXXXXXXXXXXXXXXXXXXXXXXXX-----XXX--[]XXXXXXXXXXXXXXXXXXXXXXXXXXXXX----XXXXXX----[]------XXXXXX