----------------------------------------------------------------------------------------------------
----------------------------------------------------------------------------------------------------
----------------------------------XX----------------------------------------------------------------
---------------------------------[]-------------------------xxx-------------------------------------
---------------------------------[]---------------xxxx----xxx--x------------------------------------
---------------------------------[]--------------xx---x--xxXS---x-----------------------------------
---------------------------------[]-------------xx-----xxxEX-----x----------------------------------
---------------------------------[]------------xx-------xXXX------x---------------------------------
---------------------------------[]----------xxx--------XXXXS------x----------oo--------------------
----------xxx-------------------xxxxx-------xx<>-------XXXXX--------x------------------------------x
---------xxX-x-----------------xxXXX-x-----xx-[]------XXXXXX---------x-------o--------------------xx
xxxxx---xx-X--x---------------xxXXXX--x---xx--[]-----XXXXXXX----------x------o-------------------xx-
x----xxxx--X---xxxxxxxxxxxxxxxxXXXXX---xxxx---[]----XXXXXXXX---------X-xxxxxxxxxxxxxxxxxxxxxxxxxxx--
X----XXXXXXX--XXXXXXXXXXXXXXXXXXXXXXXXXXXXXXXXXXXXXXXXXXXXXXXXXXXXXX-XXXXXXXXXXXXXXXXXXXXXXXXXXXXXXX