----------------------------------------------------------------------------------------------------
----------------------------------------------------------------------------------------------------
SSSSSSSSSSSSSSSSSSSSSSSSSSSSSSSSSSSSSSSSSSSSSSSSSSSS-SSSSSSSSSSSSSSSSSSSSSSSSSSSSSS?SSSSSSSSSSSSSSSS
]-----------------------------------------------------SSSSSSSSSSSSSSSSSSSSSSSS------SSSSSSSSSSSSSSSS
]-----------E----------------xxx----------------------SSSSSSSSSSSSSSSSSSSSSSSS------SSSSSSSSSSSSSSSS
]---QQQQ?QQQQQ--------xxxxxxxx--x---------------------SSSSSSSSSSSSSSSSSSSSSSSS------SSSSSSSSSSSSSSSS
]--------------------xxSSSSSSS---xxxxx-------------------------------------------xxxxx--------------
]-------------------xx-SSSSSSS--SSSSS-x-------------------------xxxxx-------xxxxxx----x-------------
]--xxxxxxxxxxxxxxxxxx--SSSSSSS--SSSSS--xxxxxxxxxxxxxxxxxxxxxxxxxx----xxxxxxxxE--<>-----x------xxxxxx
]-xxSSSSSSSSSSSSSSSSS--SSSSSSS--SSSSS?SS?SSSSS????????SSSSSSSSSS?----SSSSSSSSS--[]------x--xxxx-<><]
>xx-SSSSSSSSSSSSSSSSS-------------------SSSSSSSSSSSSSS--------------------------[]-------xxxXXX-[][]
xx--SSSSSSSSSSSSSSSSS---------<>--------SSSSSSS-SSSSSS------------<>------------[]-------EEXXXX-[][]
x---SSSSSSSSSSSSSSSSS---------[]----------------------------------[]------------[]------E-XXXXX-[][]
XE--XXXXXXXXXXXXXXXXXXXXXXXXXXXXXXXXXXXXXX-XX-XXXXXXXXXXXXXXXXXXXXXXXXXXXXXXXXXXXXXX-XXXEXXXXXX-XXXX