----------------------------------------------------------------------------------------------------
----------------------------------------------------------------------------------------------------
----------------------------------------------------------------------------------------------------
----------------------------------------------------------------------------------------------------
E--xxxxxxx---------E--------------------------------------------------------------------------------
SSxx-SSSSxSSSSSSSSSSSSS---------------------------------SSSSSS--------------xxxxx-------------------
-xx-------x-------------------------------------------E--------------------xx-<>-x------------------
xx---------x-------------------------------------------xxxxx--------------xx--[]--x-----------------
x-----------x------E------X--------------------------xxx----xx----------xxx---[]---x----------------
S--X?--------x-----QQ?QQQQX-------------------------xx<>---<>-x--------xx<>--QQQ?---x---------------
--XX----------x------------------------------------xx-[]---[]--x------xx-[]----------x--------------
-XXX-----------xx---------------xxx---------------xx--[]---[]---x----xx--[]-----------x-----xxx-----
XXXX-----------X-xxxxxxxxxxxxxxxx-Exxxxxxxxxxxxxxxx---[]---[]----xxxxx---[]------E-----xxxxxxE-xxxxx
XXXXXXXX-------XXXXXXXXXXXXXXXXXX--XXXXXXXXXXXXXXXXXXXXX---XX--XXXXXXXXXXXXX-----X---XXXXXXXXXXXXXXX