----------------------------------------------------------------------------------------------------
----------------------------------------------------------------------------------------------------
---------------------------------------------SSSSSSSSSSSSSSSSSSSSSSSSSSSSSSSSSSSSSSSSSSSSSSS--------
-----------------------------------------------[]---------SSSSSSSSSSSSSSSSSSSSSSSSS----------------x
-----------------------------------------------[]---------SSSSSSSSSSSSSSSSSSSSSSSSS-----------XXX-xx
-----------------------------E-----------------[]---------SSSSSSSSSSSSSSSSSSSSSSSSS--QQ------xxxx-xS
-----------------------------------------------<>-------------------------------------------xx---xx-
------------------------------------xx---------------------------xxx--------------xxx-xxx--xx-----xS
---------------------------xxxx----xx-x-------------------xxxxxxxx?-xxxxxxxxxxxxxxx--xx--xxx------S-
--------------xxxx--------xx<>-xxxxx---x-----------------xx-SSSSSS??SSSSSSSSSSSSSSS--QQ--QQQ--------
x------------xx<>-x------xx-[]-XX-x-----x-----------XX--xx--SSSSS---SSSSSSSSSSSSSSS-----------------
-x----------xx-[]--x----xx-X[]-XXXX------x----xxx------xx---SSSSS---SSSSSSSSSSSSSSS-----------------
-Exxxxxxxxxxx--[]---xxxxx-XX[]-XXXXX----X-xxxxx--xxxxxxx---------oooSSSSSSSSSSSSSSS-----------------
XXXXXXXXXXXXXXXXXXXXXXXXXXXXXXXXXXXXXXXXXXXXXXX--XXXXXXX---XXXXXXXXXXXXXXXXXXXXXXXXXXXXXXXXX------XX