----------------------------------------------------------------------------------------------------
---------------------------------------------------------------------xx-----------------------------
--------SSSSSSSSSSSSSSSSSSSSSSSSSSSSSSSSSSSSSSSSSSSSSSSSSSSSS-------xx-xxx--------------------------
----------[]----[]-------------------------------------------------xx--XX-x-------------------------
----------[]----[]-------E----------------xxx-----------------XXX-xx---XX--x------------------------
----------[]----[]---QQQQQQ--------xxxxxxxx--x---------------xxxx-xS---XX---x-----------------------
----X-----<>----[]----------------xxSSSSSSS---xxxxx---------xx---xx----XX----x----------------------
-x--X-----------[]---------------xx-SSSSSSS--SSSSS-x-------xx-----x----XX-----x---------------------
xx-XX-----------[]--xxxxxxxxxxxxxx--SSSSSSS--SSSSS--xxxxxxxx------S----XX------x------------------B-
X--XX-----------[]-xxSSSSSSSSSSSSS--SSSSSSS--SSSSS?SS?SSSSSS------S----XX-------x---------B-------b-
X-xXX-----------<>xx-SSSSSSSSSSSSS-------------------SSSSSS-------SS---XX--------x--------b--?-B----
X--x-----xxx-----xx--SSSSSSSSSSSSS---------<>--------SSSSSS-------SS---XX---------x-------B----b----
X---xxxxxx--xxxxxx---SSSSSSSSSSSSS---------[]--------------o------SS---XX--------X-xxxxxxxxxxxxxxxxx
XXXXXXXXXX--XXXXXXE--XXXXXXXXXXXXXXXXXXXXXXXXXXXXXXXXXX-XX-X------XXXXXXXXXXXXXXXXXXXXXXXXXXXXXXXXXX