----------------------------------------------------------------------------------------------------
----------------------------------------------------------------------------------------------------
SSSSSSSSSSSSSSSSSSSSSSSSSSSSSSSSSSSSSSSSSSSSSSSSSSSSSSSSSS?SSSSSSSSSSSSSSSSSSSSSSSSSSSSSSSSSSSSS----
-----------------------SS--SSSSSS--SSSS------SSSS---------------------------------------------------
-----------------------SS--SSSSSS--SSSS--E---SSSS---------------------------------------------------
----------oooo-------SS--------SS---S----SS----------oooooo--------------------------------------xx-
---------------------SS--------SS---S----SS--------------------------------xx-------------------xx-x
--------S-SSSS-S-----SS--------SS---S----SS----------SSSSSS---------------xx-x-xxx-------------xx--X
x-------SoS--SoS-----SS----ooooSS---So??-SS---E------SSSSSS--------------xx---xx--x--------xxxxx----
-xx-----SSS--SSS-----SSSS--SSSSSS---SSS--SS--SSSS----------------------xxx----<>---x------xx-XXX----
XX-xx------------------SS-------------------EE------------------------xx<>----[]----xxx--xx---------
XXXX-x-----------------SS-----------------------xxxxx----------------xx-[]----[]----<>-xxx----------
XXXX--xxxxxxxxxxxxxxxxxxxxxxxxxxxxxxxxxxxxxxxxxxx----xxxxxxxxxxxxxxxxx--[]----[]--E-[]--x-----------
XXXXXXXXXXXXXXXXXXXXXXXXXXXXXXXXXXXXXXXXXXXXXXXXX---XXXXXXXXXXXXXXXXXXXXXXXXXXXXXXXXXXXXX----------X