----------------------------------------------------------------------------------------------------
----------------------------------------------------------------------------------------------------
----------------------------------------------------------------------------------------------------
-------------------------------------------------------------xxx------------------------------------
---------------------------------------------------xxxx----xxx--x-----------------------------------
-----------------------E-E-E-------------S--------xx---x--xxXS---x----------------------------------
----------------------<><><>---------------------xx-----xxxEX-----x---------------------------------
----------------------[][][]--------------------xx-------xXXX------x--------------------------------
--oo--------------Q?--QQQQQQ---------------xxxxxx--------XXXXS------x-------------------------------
-o--o---------------------------------Q--xxx---<>-------XXXXX--------x---------B--------------------
--------------------------------xxxx----xx<>---[]------XXXXXX---------x--------b--?-B---?QQ---------
-------------------xxx---------xx<>-x--xx-[]---[]-----XXXXXXX----------x-------B----b---------------
xxxxxxxxxxxxxxxxxxxx--xxxxxxxxxx-[]--xxx--[]---[]----XXXXXXXX---------X-xxxxxxxxxxxxxxxxxxxxxxxxxxxx
XXXXXXXXXXXXXXXXXXXX--XXXXXXXXXXXXXXX-XXX-XX--XXXXX-XXXXXXXXXXXXXXXXX-XXXXXXXXXXXXXXXXXXXXXXXXXXXXXX