-xxxx-----------------------------------------------------------------------------------------------
xx---x-----------------------------------------------------xxx--------------------------------------
x-----x-----------------------E---------------------------xx--x-------------------------------------
x------x-------------------------------------------------xx----xx-----------------------------------
--------x-----------------------------------------------xx-----E-xxxxxx-----------------------------
---------x------------SSSSSSSS?S--------S----S--------xxx---------x----x-------SSSSSS-----------E---
----------x------------[]----------------------------xx-S--------<>-----x----------------------<>---
-E---------x-----------[]---------------------------xx-----------[]------xxxx-------xxx--------[]---
<>-----E----x----------[]--------------xxxx--------xx------------[]-------xB-xxxxxxxx--x-------[]---
[]----<>-----xxx-------[]-------------xx<>-x------xx-------X-----XX-------XXXXESSSSSS---x------XXX--
[]----[]-----[]-x------<>------------xx-[]--x----xxE---------------------XXXXXX----------x---------x
[]----[]-----[]--x-----xxx----------xx--[]---x--xx<>--------------------XXXXXXX-----------x-------xx
[]----[]-----[]---xxxxxxE-xxxxxxxxxxx---[]----xxx-[]-----X-------------XXXXXXXX----------B-xxxxxxxx-
XXXX--[]--XXXXXXXXXXXXXXXXXXXXXXXXXXXXXXXXXXXXXXXXXXXXXXXX-------------XXXXXXXXXXXXXXXEXXXXXXXXXXXXX