----------------------------------------------------------------------------------------------------
----------------------------------------------------------------------------------------------------
-------------------------------------------------------------------------S--------------------------
----------------------------------------------------------------------------------------------------
----------------------------------------------------------------------------------------------------
-----------------------------------E---S---SSSSSSSSS----------------SS---SS-------------SSS-----E---
----------------------------------<>-----------------------------------------------------------<>---
----------------------------------[]-----------------------------------------------------------[]---
B---------------------------------XXX------------xxxx-------------SS--------------xxxxx--------[]---
b-----------------------------------------------xx--xxx-xxx-xxx---------SSS---xxxxx-XX-xSSS----XXX--
----?QQ-------------------------------xxxx-----xx------xx--xx--xxx-----------xxXX<>-XX--x----------x
-------------------xxx---xxxx--------xx<>-x---xx-------<>--<>--<>-x-xxxxx---xxXXX[]-XXX--x--------xx
xxxxxxxxxxxxxxxxxxxx--xxxx---xxxxxxxxx-[]--xxxx--------[]--[]--[]--xx----xxxxXXXX[]-XXX---xxxxxxxxx-
XXXXXXXXXXXXXXXXXXXX--XXXX--XXXXXXXXXXXXXXXXXXX------XXXXXXXXXXXXXXXX-X-XXXXXXXX-XXXXXXXXXXXXXXXXXXX