----------------------------------------------------------------------------------------------------
----------------------------------------------------------------------------------------------------
----SSSSSSSSSSSSSSSS--------------------------------------------------------xxx-----xxxx-----xx-----
xx--SSSS-------------------------------------------------------------------xx--x---xx---x-?-xx-x----
--x-SSSS--------------xxxx------------------------------------------xxx---xx----x-xx-----x-xx---x-xx
---xSSSS-------------xx---x----------------------------------------xx--x-xx------xx-------xx-----xx-
----x---------------xx-----xxxxxxxxxxx----------------------------xx-E--xx-------XX-------XX-----XX-
-----x-------------xx-------xXXXXXXXX-x-------------------xxx----xx-----XX--------------------------
-----oxxx------xxxxx--------XXXXXXXX---x----xx-----------xx--xxxxx----------------------------------
----S?SS-x----xx-XXX-------XXXX---------x--xx-x-xxxxx---xx---XXXXX-------o--------------------------
----SSS---x--xx-----------XXXXX----------xxx---xx----x-xx----------------o--XX----------------------
B---SS-----xxx-----------XXXXXX-----------x----<>-----xx--------------------------------------------
------E-EE--xX----------XXXXXXX---<>-----<>----[]-----<>--------------------------------------------
XXXXXX-XXXXXXX---------XXXXXXX----[]-----[]----[]-----[]--------------------------------------------