----------------------------xxxxxxxx----------------------------------------------------------------
xxxxxxxxxxxxxxxxxxxxxxxxxxxxx-XXX---xxxxxxxxxxxxxxxxxxxxxxxxxxxxxx----------------------------------
SSSSSSSSSSSSSSSSSSSSSSSSSSSSS-------SSSSSSSSSSSSSSSSSSSSSSSSSSSSS-x---SSSSSSSSSSSSSSSS-------------S
------------------------------------SSSS---------------------------x--SSSS--------------------------
------------------------------------SSSS----------------------------x-SSSS--------------------------
--E-E-E-----------------------------SSSS----E------------------------xSSSS-------------xx--xxxxx----
-<><><>------------------------------------<>-------------------------x---------------xx-xxx----x---
-[][][]------------------------------------[]------------E-------------x----------x--xx--XXX-----x--
-QQQQQQ---------E---------------------E----[]-----------<>-------------oxxx------xxxxx------------x-
----------E----<>--------------------<>---?SSS--E-------[]------------S?SS-x----xx-XXX-------------x
---------<>----[]-----------XX-------[]--------<>-------[]------------SSS---x--xx-----------SSS-S--S
---------[]----[]----------XXXXXX----[]--------[]---<>--[]-----<>-----SS-----xxx------------SSS-S--S
---------[]----[]---------XXXX-------[]--------[]---[]--[]-----[]-------E-EE--xX------------SSS-S--S
XXXXXXXXXXXXXXXXX--XXXXXXXXXX-----XXXXXXXX----XXX---XX--XX--XXXXXXXXXXXX-XXXXXXX---------XXXSSS-S--X