----------------------------------------------------------------------------------------------------
----------------------------------------------------------------------------------------------------
----------------------------------------------E-----------------------------------------------------
----------------------------------------------------------------------------------------------------
----------------------------------------------------------------------------------------------------
-----------------------------------------------XX-----------------------------------------XXX-------
-----------------------------------------------------------------------------XXXoo-----------------<
---------------------E--------------------------------------------------------------X---------------
----------------------XXX--------------X----X--------------------xxx--------------------------------
--xxx-------------------------------X---------------------------xx--x---------------------------XXXx
-xxX-x------------------------------X--------------------------xx----x------------------------------
xx-X--x----------------------<>-----X-------------------x-----xx------x-----------------------------
x--X---xxxxxxxxxxxxxx--------[]-----X---------X----------xxxxxx--------xxxxx------------------------
XXXXXXXXXXXXXXXXXXXXX--------XXXXXXXX----XXXXXX---------XXXXXXX--------XXXX-------------------------