----------------------------------------------------------------------------------------------------
----------------------------------------------------------------------------------------------------
E---------------------------------------------------------------------------------------------------
>--------------------------------------xxxx---------------------------------------------------------
]------------------------------------xxx---x-----------------------------------------------------xxx
XXX----------E----------------------xx-X----x-----S---------E---------------------------------E-xxXX
------------<>---------------------xx--------x----S--------<>----------------------------------xxXXX
------------[]-----------xxxxxxxxxxx----------x------------[]------xxxxx----xxxxx-------------xxXXXX
-------xxxx-XXX--------xxx----x---<>-----------x--SSS------[]----xxx----x-xxx----x----------xxxXXXXX
------xx<>-x----------xx<>---SS---[]------------x-SSS------XXX--xx<>-----xx<>-----xx-------xx<>XXXXX
-----xx-[]--x-xxxx---xx-[]--------[]-------------xSSS----------xx-[]----E<>[]----<>-x-----xx-[]XXXXX
----xx--[]---xx<>-x-xx--[]--------[]---------------SSx--------xx--[]---<>[][]----[]--x---xx-X[]XXXXX
xxxxx---[]----x[]--xx---[]--------[]-------------X-SS-xxxxxxxxx---[]---[][][]----[]---xxxx-XX[]XXXXX
XXXXXXXXXXXXXXXXXXXXXXXXXXXXXXXXXXXXXXXXXXXX-----XXXXXXXXXXXXXXXXXXXXXXXXXXXXXXXXXXXXXXXXXXXXXXXXXXX