----------------------------------------------------------------------------------------------------
----------------------------------------------------------------------------------------------------
SSSSSSSSSSSSSSSSSSSSSSSSSSSSSSSSSSSSSSSSSSSSSSSSSSSSSSSS-----SSSSSSSSSSSSSSSSSSSSSS]SSSSSSSSSSSSSSSS
-------[]---------------------------------------------[]---------------------------]SSSSSSSSSSSSSSSS
-------[]------E----------------xxx-------------------[]---------------------------]SSSSSSSSSSSSSSSS
-------[]---QQQQQ--------xxxxxxxx--x------------------[]------xxxxxxxxx-----------<]SSSSSSSSSSSSSSSS
-------[]---------------xxSSSSSSS---xxxxx-------------[]------xSSSSSSS-x----------[]SSSSSSSSSSSSSSSS
-------[]--------------xx-SSSSSSS--SSSSS-x------------[]------xSSSSSSS--x-------xx[]SSSSSSSSSSSSSSSS
Q?-----[]--xxxxxxxxxxxxx--SSSSSSS--SSSSS--xxxxx-------[]---xxxxSSSSSS----x-----xxX]]SSSSSSSSSSSSSSSS
-------[]-xxSSSSSSSSSSSS--SSSSSSS--SSSSS?SS?SS-xx-----[]--xx--?SSSSS------x---xxXXXXXSSSSSSSSSSSSSSS
-------<>xx-SSSSSSSSSSSS-------------------SSS-S-x----<>-xx----------------x-xxXXXXXXSSSSSSSSSSSSSSS
-xxx----xx--SSSSSSSSSSSS---------<>--------SSSXSS-x-----xx------------------xxXXXXXXXSSSSSSSSSSSSSSS
xx--xxxxx---SSSSSSSSSSSS---------[]----------------xxxxxx-------------------XXXXXXXXXSSSSSSSSSSSSSSS
XX--XXXXXE--XXXXXXXXXXXXXXXXXXXXXXXXXXXXXXXXX-XXXEXXXXXXX----XXXXXXXXX------XXXXXXXXXXXXXXXXXXXXXXXS