----------------------------------------------------------------------------------------------------
----------------------------------------------------------------------------------------------------
----------------------------------------------------------------------------------------------------
----------------------------------------------------------------------------------------------------
------------------xxxxxxxxxxx----------E-E------------------xxxxx-----------------------------------
-----E-----------xx--QQQ?QQQ-x-------SSSSSSS-SS-xxxx-----xxxx--X-x----------------------------------
----<>----------xx------------x-------------E--xx---x---xx--E--X--x---------------------------------
x---[]---------xx------E-------x--------------xx-----x-xx---XX-X---x--------------------------------
-xx-XXX------xxx-----SSSSSSS----x-----------xxx-------xx----XX-X----x-------------------------------
<>-x-------x-x<>--------------E--x---------xx<>-------<>----XX-X-----x----------------------xxx-----
[]--x-xxxxxxx-[]-------X------X---x---E---xx-[]-------[]----XX-X------x--------------------xxX-x----
[]---xx<><>-x-[]-------X------X----x-----xx--[]-------[]----XX-X-------X-----xxxx-------B-xx-X--x---
-]----x[][]---[]----E--X------X-----xxxxxx---[]-------[]----XX-X-------xxxxxxx---xxxxxxxxxx--X---xxx
XXXXXXXXXXXXXXXXXXXXXXXXXXXXXXXXXXXXXXXXXXXXXXX-------XX-XXXXX-XXXXXXXXXXXXXXX---XXXXXXXXXX--XXXXXXX