----------------------------------------------------------------------------------------------------
----------------------------------------------------------------------------------------------------
----------------------------------------------------------------------------------------------------
----------------------------------------------------------------------------------------------------
----------------------------------------------------------------------------------------------------
------------------------------------------------------E--S---SSSSSSSSS------------SS---SS-----------
-----------------------------------------------------<>---------------------------------------------
-----------------------------------------------------[]---------------------------------------------
--------------------------S----------------xxxx------[]------------xxxx---------SS--------------xxxx
---------------------------------xxx------xx<>-x----SXXS----------xx--xxx-xxx---------SSS---xxxxx-XX
----------------xxxx-----xxx----xxX-x----xx-[]--xx------xxxx-----xx------xx--xxx-----------xxXX<>-XX
x-xx-----------xx<>-x---xxS-x--xx-X--x--xx--[]-<>-x----xx<>-x---xx-------<>--<>-x-xxxxx---xxXXX[]-XX
-xxXxxxxxxxxxxxx-[]--xxxx-S--xxx--X---xxx---[]-[]--xxxxx-[]--xxxx--------[]--[]--xx----xxxxXXXX[]-XX
XXXXXXXXXXXXXXXXXXXXXX<>XXXXXXXXXXXXXXXXXXXXXXXXXXXXXXXXXXXXXXXXX------XXXXXXXXXXXX-X-XXXXXXXX-XXXXX