----------------------------------------------------------------------------------------------------
-------------------------------------------------------------------------------------------------xx-
------------------------------------------------------------------------------------------------xx-x
----------------------------------------------------------------------------------------xxx----xx---
----------------E-----------------------xxxx--------------------------------------xx---xx--xxxxx----
---------------SQS--SQS----------------xxXX-x-------------------------E----------xx-x-xx---SSSSS----
-----xxxx-----------------------------xxXXX--x----------------------------------xx---xx-------------
----xxXX-x---------------------------xxXXXX---x-----------------------xxxxxxxxxxx----<>-------------
---xxXXX--x-------------------------xxXXXXX----x--------------------xxx----x---<>----[]-------------
--xxXXXX---x---SQS--S?S------------xxXXXXXX--S--x------------------xx<>---SS---[]----XXX------------
-xxXXXXX----x---------------E----ExxXXXXXXX------x----------------xx-[]--------[]-----------E------E
xxXXXXXX-----x-------------------xxXXXXXXXX-------xx--------xxxx-xx--[]--------[]----------<>-----<>
xXXXXXXX-----ExxxxxxxxxxxxxxxxxxxxXXXXXXXXX-------X-xxxxxxxxx---xx---[]--------[]----------[]-----[]
XXXXXXX--XXXXXXXXXXXXXXXXXXXXXXXXXXXXXXXXXXXXXXXXXXXXXXXXXXXX--XXXXXXXXXXXXXXXXXXXXXXXXXXXXXXXXXXXXX