----------------------------------------------------------------------------------------------------
----------------------------------------------------------------------------------------------------
----------------------------------------------------------------------------------------------------
----------------------------------------------------------------------------------------------------
---------------xxx------x---------------------------------------------------------------------------
---------------x--x----xxxxx------------------XX----------------------------------------------------
---------------x---x--xx-<>-x-----------------[]----------------------------------------------------
----------xxxxxx----xxx--[]--x----------------[]----------------------------------------------------
--------xxx----x----ox---[]---x----xxxx-------[]---------------------------------<>-----------------
oSS----xx<>---SS---S?S---[]----x--xx---xx-----<>SSSSSS---------------------------[]---?QQQQQQQ?-----
------xx-[]--------SS----[]-----xxx----X-x---------------------------E-----------[]-----------------
-----xx--[]--------SS----[]------x-----XX-xx---Exxx------------------------------[]---B-------------
xxxxxx---[]--------------[]------B-----XXXX-xxxxxE-xxxxxxxxxxxxxxxxxxxxxxxxxxxxxx[]---b-E-----B-----
XXXXXXXXXXXXXXXXXXXXXXXXXXXXXXXXXX-----XXXXXXXXX<>XXXXXXXXXXXXXXXXXXXXXXXXXXXXXXXXXXXXXXXXXX-XXXXXXX