----------------------------------------------------------------------------------------------------
----------------------------------------------------------------------------------------------------
----------------------------------------------------------------------------------------------------
----------------------------------------------------------------------------------------------------
xx----------------------------xxx-xxx-----------------------xxxxxxx---------------------------------
--x--------------------------xx--xx--x---------------------xx-SSSS-x--------------------------------
---x------------------------xx---<>---x-------------------xx--------x-------------------------------
----x----------------------xx----[]----x-----------------xx----------x------------------------------
-----x--------------------xxX----[]-----x---------------xxX-----------x---------------------xxxx----
------x-------------------x------XX------x-------S?S---xxEX---S-----X--x-------------------xx<>-x---
-------x-----------------xx---------------x-----------xxXXX---------X---x-----------------xx-[]--xx-
--------xx--------------xx-----------------x---------xxXXXX---------XX---x---------------xx--[]-<>-x
E-------X-xxxxxxxxxxxxxxx---------E-------X-xxxxxxxxxxXXXXX----EE---XX---Exxxxxxxxxxxxxxxx---[]-[]--
XXXXXXXXXXXXXXXXXXXXXXXXXXXXXXXXXXXXXXXXXXXXXXXXXXXXXXXXXXXXXXXXXXXXXXXXXXXXXXXXXXXXXXXXXXXXXXXXXXXX