----------------------------------------------------------------------------------------------------
---------------------------------------------------------xxxxx--------------------------------------
------------------------------oo-----------------S------xx----x---------------------------------oo--
-------------------------------------------xxx---S-xxx--xQ-----xxx----------------------------------
----------------------------------------xxxx-oxoooxx--xxx-----XXX-x---------------------------------
------------------------------XXX------xx-XX---x-xx----x-----------x----------------------------XXX-
--------------------------------------xx--------xx-----XX-----------x-------------------------------
-------------------------------------xx---------XX-------------------x------------------------------
--------------------------------xxxxxx--------------------------------x---------------------------xx
------------------------XXXX---xxXXXXX-----------------------------XXX-x-----------------XXXX----xxX
x-----------------------------xx----------------------------------------x-----------------------xx--
-xxx-------xxxxx-xxx----xxx--xx--------------------XXXXX-----------------xxx-------xxx---xxx---xx---
-XX-xxxxxxxx----xx--xxxxx--xxx-------------------------------------------XX-xxxxxxxx--xxxx--xxxx----
XXXXXXXXXXXX---XXX--XXXXX--XXX---------XXXX--XXXX----------------------XXXXXXXXXXXXX--XXXX--XXXX----