----------------------------------------------------------------------------------------------------
----------------------------------------------------------------------------------------------------
-------------------------------------------------------------------------------------xx-------------
------------------------------------------------------------------------------------xx-x------------
-------xxxxxxxxxx----------E-E------------------xxxxx------------------------xxx---xx---x-----------
------xx--QQQ?QQ-x-------SSSSSSS-SS-xxxx-----xxxx--X-x----------------------xx--x-xx-----xxxxxxxxxxx
-----xx-----------x-------------E--xx---x---xx--E--X--x--------------------xx-E--xx------SSSSSSSSSSS
----xx------E------x--------------xx-----x-xx---XX-X---x------------------xx-----XX-----------------
--xxx-----SSSSSS----x-----------xxx-------xx----XX-X----x-----------xxxxxxx-------------------------
-xx<>-------------E--x---------xx<>-------<>----XX-X-----x---------xx-XXXXX-------o-------------E---
xx-[]-------X-----X---x---E---xx-[]-------[]----XX-X------x-------xx--------------o------------<>---
x--[]-------X-----X----x-----xx--[]-------[]----XX-X-------S-----xx----------------------------[]---
---[]----E--X-----X-----xxxxxx---[]-------[]----XX-X-------xxxxxxx-----------------------------[]---
XXXXXXXXXXXXXXXXXXXXXXXXXXXXXXXXXXX-------XX-XXXXX-XXXXXXXXXXXXXXX-----------------------------[]---