----------------------------------------------------------------------------------------------------
----------------------------------------------------------------------------------------------------
----------------------------------------------------------------------------------------------------
----------------------------------------------------------------------------------------------xxx---
------------------------------------------------------------------------------------xxxx----xxx--x--
-------xxxx------------------XX--------------------------E-E-E------------S--------xx---x--xxXS---x-
-------x<>-x-----------------[]-------------------------<><><>--------------------xx-----xxxEX-----x
-------x[]--x----------------[]-------------------------[][][]-------------------xx-------xXXX------
-E----xx[]---x----xxxx-------[]---------------------Q?--QQQQQQ--------------xxxxxx--------XXXXS-----
-----xxS[]----x--xx---xx-----<>SSSSSS----------------------------------Q--xxx---<>-------XXXXX------
----xx--[]-----xxx----X-x-----------------------------------------xxxx---xx<>---[]------XXXXXX------
---xx---[]------x-----XX-xx---Exxx-------------------xxx---------xx<>-x-xx-[]---[]-----XXXXXXX------
xxxx----[]------B-----XXXX-xxxxxE-xxxxxxxxxxxxxxxxxxxx--xxxxxxxxxx-[]--xx--[]---[]----XXXXXXXX------
XXXXXXXXXXXXXXXXX-----XXXXXXXXX<>XXXXXXXXXXXXXXXXXXXXX--XXXXXXXXXXXXXX-XXX-XX--XXXXX-XXXXXXXXXXXXXXX