----------------------------------------------------------------------------------------------------
xxxxxxxxxxxxxxxxxxxxxxxxxxxxxxx---------------------------------------------------------------------
SSSSSSSSSSSSSSSSSSSSSSSSSSSSSS-x---SSSSSSSSSSSSSSSS-------------SSS-[]SSSSSSSSSSSSSSS---------------
SS------------------------------x--SSSS-----------------------------[]SSSSSSSSSSSSSSS---------------
SS-------------------------------x-SSSS-----------------------------[]SSSSSSSSSSSSSSS---------------
SS----E---------------------------xSSSS-------------xx--xxxxx-------[]SSSSSSSSSSSSSSS---------------
-----<>----------------------------x---------------xx-xxx----x------[]SSSSSSSSSSSSSSS---------------
-----[]------------E----------------x-------------xx--XXX-----x-----[]SSSSSSSSSSSSSSS---------------
E----[]-----------<>----------------oxxx------xxxxx------------x-----]SSSSSSSSSSSSSSS--------------X
>---?SSS--E-------[]---------------S?SS-x----xx-XXX-------------xxxx-]SSSSSSSSSSSSSSS--------E----XX
]--------<>-------[]--<>-----E-----SSS---x--xx-----------SSS-S--SSSSSSSSSSSSSSSSSSSSS---E---<>---XXX
[--------[]---<>--[]--[]----<>-----SS-----xxx------------SSS-S--SSSSSSSSSSSSSSSSSSSSS--<>---[]--XXXX
[--------[]---[]--[]--[]----[]-------E-EE--xX------------SSS-S--SSSSSSSSSSSSSSSSSSSSS--[]---[]-XXXXX
XXXX----XXX---XX--XX--XX--XXXXXXXXXXX-XXXXXXX---------XXXSSS-S--XXXXXXXXXXXXXXXXXXXXX--XX---XXXXXXXX