----------------------------------------------------------------------------------------------------
----------------------------------------------------------------------------------------------------
------------------------------------------------------------------------------------xxx-----xxxx----
-----------------------------------------------------------------------------------xx--x---xx---x---
----xxxxxxxxxxx----------E-E------------------xxxxx-------------------------xxx---xx----x-xx-----x-x
---xx--QQQ?QQQ-x-------SSSSSSS-SS-xxxx-----xxxx--X-x-----------------------xx--x-xx------xx-------xx
--xx------------x-------------E--xx---x---xx--E--X--x---------------------xx-E--xx-------XX-------XX
-xx------E-------x--------------xx-----x-xx---XX-X---x-------------------xx-----XX------------------
xx-----SSSSSSS----x-----------xxx-------xx----XX-X----x------------xxxxxxx--------------------------
<>--------------E--x---------xx<>-------<>----XX-X-----x----------xx-XXXXX-------o------------------
[]-------X------X---x---E---xx-[]-------[]----XX-X------x--------xx--------------o--XX--------------
[]-------X------X----x-----xx--[]-------[]----XX-X-------S------xx----------------------------------
[]----E--X------X-----xxxxxx---[]-------[]----XX-X-------xxxxxxxx-----------------------------------
XXXXXXXXXXXXXXXXXXXXXXXXXXXXXXXXX-------XX-XXXXX-XXXXXXXXXXXXXXXX-----------------------------------