-xxxx------------------xxx---------xxx---------------------------------------------------------xxx--
xx---x-------xxx------xx--x-------xx--x------xxxx----------------xxxx-----------xxx-----------xx--x-
x-----x-----xx--x----xx----x-----xx----x----xx---x-----xx-------xx---x---------xx--x---------xx----x
>------x---xx----x--xx------x---xx------x--xx-----x---xx-x-----xx-----xx------xx----xx------xx------
]-------x-xx------xxx--------xxxx--------xxx-------x-xx---xxxxxx------E-xxxxxxx-----E-xxxxxxx-------
X--------xx-------XXX--------XXXX--------XXX--------xx----XXXXXX--------XXXXXXX-------XXXXXXX-------
---------XX-----------------------------------------XX----------------------------------------------
-------------------------oo-------------------------------------------------------------------------
-------------------------SS-------------------------------------------------------------------------
-E---------------------------------------------XX---------------------------------------------------
<>--------------------------------------------------------------------------------------------------
[]--------------------------------------------------------------------------------------------------
[]---------------o---o------------------------------------------------------------------------------
XXXX-------------X---X--------------XXX-------------------------------------------------------------