----------------------------------------------------------------------------------------------------
-------------------------------------------------------------------------------------------------xxx
-------------------------------------------------------------------------------------------------xXX
--------------------------------------------------------------------------XXXXXXXXXXXXXXXX------xxXX
-------------------------------------------------------------------------XX--------------------xx-XX
---------------------------------------------------------E--------------XXX--------------------xS-XX
--------------------------------------------------------<>-------------XXXX--------------------x--XX
--------------------------------------------------------[]------------XXXXX-------------------xx--XX
-----------------------------<>-------------------------[]-----------XXXXXX------------------xxS--XX
------------ooo--------------[]----?QQQQQQQ?------E--SSS[]SS---E----XXXXXXX------------------x----XX
-----------------------------[]------------------<>-----[]----<>---XXXXXXXX---<>----<>------xx----XX
x----------------------------[]----B-------------[]-----[]----[]--XXXXXXXXX---[]----[]-----xx---E-XX
oxxxxxxxxxxxxxxxxxxxxxxxxxxxx[]----b-E-----B-----[]-E---[]----[]-XXXXXXXXXX---[]----[]-----x------XX
XXXXXXXXXXXXXXXXXXXXXXXXXXXXXXXXXXXXXXXXX-XXXXXXXXXXXXXXXXXXXXXXXXXXXXXXXXXXXXXXXXXXXXXXXXXXXXXXXXXX