x---------------------------------------------------------------------------------------------------
xxxxxxxxxxxxxxxxxxxxxxxxxxxxxxxxxxxxxxxxxxx---------------------------------------------------------
SSSSSSSSSSSSSSSSSSSSSSSSSSSSSSSSSSSSSSSSSS-x-------------SSSSSSSSSSSSSSSSSSSSSSSSSSSSSSSSSSSSSSSSSSS
SSSSSSSSSSSSSS------------------------------x--------------[]---------------------S-SS--SSSSSS--SSSS
SSSSSSSSSSSSS--------------------------------x-------------[]---------------------S-SS--SSSSSS--SSSS
SSSSSSSSSSSSS---------------------------------x------------[]----oo------SS-----SSS---------SS---S--
-----------------------------------------------x-----------<>------------SS-----SSS---------SS---S--
------------------------------------------------x---------------SS-------SS-----SSS---------SS---S--
E----------------S--------------------E----------x--------------SSoo-----SS------SS-----ooooSS---So?
>-------E--SS--E----E----------------<>-----------x-------------SSoo-----SS------SS-S---SSSSSS---SSS
]-<>---<>-----<>---<>-------------XX-[]--XXX-------x------------------------E-------S---------------
]-[]---[]-----[]---[]------------XXX-[]--XXX--------xx----xxx-----------------------So--------------
]-[]---[]-----[]---[]--------E-E-XXX-[]--XXX-------XX-xxxxx--xxxxxxxxxxxxxxxxxxxxxxxxxxxxxxxxxxxxxxx
XXXXXXXXXXXXXXXXXXXXXXXXXXXXXXXXXXX--XX--XX--------XXXXXXXX--XXXXXXXXXXXXXXXXXXXXXXXXXXXXXXXXXXXXXXX