---------------------------------xxx----------------------------------------------------------------
----xxxxxxxxxxxxxxxxxxxxxxxxxxxxxx--x---------------------------------------------------------------
----xXXXXXXXXXXXXXXXXXXXXXXXXXXXXX---x------------SSSSSSSSSSSSSSSSSSSSSSSSSSSSSSSSSSSSSSSSSSSSSSSSSS
---xxXXXXXXXXXXXXXXXXXXXXXXXXXXXXX----x-------------[]---[]-----------------------------------------
--xx-XXXXXXXXXXXXXXXXXXXXXXXXXXXXX-----x------------[]---[]-------E---------------xxx---------------
--xS-XXXXXXXXXXXXXXXXXXXXXXXXXXXXX------x-----------[]---[]---QQQQQQ--------xxxxxxx--x--------------
--x--XXXXXXXXXXXXXXXXXXXXXXXXXXXXX-------x----------<>---[]----------------xxSSSSSS---xxxxx---------
-xx--XXXXXXXXXXXXXXXXXXXXXXXXXXXXX--------x--------------[]---------------xx-SSSSSS--SSSSS-x--------
xxS--XXXXXXXXXXXXXXXXXXXXXXXXXXXXX---------x-------------[]--xxxxxxxxxxxxxx--SSSSSS--SSSSS--xxxxxxxx
x----XXXXXXXXXXXXXXXXXXXXXXXXXXXXX----------x------------[]-xxSSSSSSSSSSSSS--SSSSSS--SSSSS?SS?SSSSSS
-----XXXXXXXXXXXXXXXXXXXXXXXXXXXXX-----------x-----------<>xx-SSSSSSSSSSSSS------------------SSSSSSS
---E-XXXXXXXXXXXXXXXXXXXXXXXXXXXXX------------x----xxx----xx--SSSSSSSSSSSSS--------<>--------SSSSSSS
-----XXXXXXXXXXXXXXXXXXXXXXXXXXXXX-----------X-xxxxx--xxxxx---SSSSSSSSSSSSS--------[]---------------
XXXXXXXXXXXXXXXXXXXXXXXXXXXXXXXXXX--XXXXXXXXXXXXXXXX--XXXXXE--XXXXXXXXXXXXXXXXXXXXXXXXXXXXXXXXX-XX-X