----------------------------------------------------------------------------------------------------
----------------------------------------------------------------------------------------------------
--------------------------------------------------SSSSSSSSSSSSSSSSSSSSSSSSSSSSSSSSSSSSSSSSSSSSSSSSSS
-----------------------------------------------------------------SSSSSSSSSSSSSSSSSSSS]SSSS----------
---------------------------------xxxxx---------------------------SSSSSSSSSSSSSSSSSSSS]SSSS----------
-----------XX----------xxx------xxXX--x--------------------------SSSSSSSSSSSSSSSSSSSS]SSSS--QQ------
-----------XX---------xx--x----xxXXX---x---------------------------------------------]--------------
-----------XXXXXXXX--xx----x--xxXXXX----x------------------------------xxx-----------]---xxx-xxx--xx
-Q?--------XX-------xx------xxxXXXXX-----x-----------------------xxxxxxx?-xxxxxxxxxxxxxxxx--xx--xxx-
-----------X--x----xx--------xXXXXXX---S--x---------------------xx-SSSSS??SSSSSSSSSSSSSSSS--QQ--Q<>-
------------xx-xxxxx--------XXXXXXXX-------x-------------------xx--SSSS---SSSSSSSSSSSSSSSS-------[]-
--xxx------xx-XXXXXX-------XXXXXXXXX--------xx---------xxx-xxxxx---SSSS---SSSSSSSSSSSSSSSS-------[]-
xxx--xxxxxxx--------------XXXXXXXXXX--------X-xxxxxxxxxx--xx--x--------oooSSSSSSSSSSSSSSSS-------[]-
XXX--XXXXXXXX------------XXXXXXXXXXXXXXXXXXXXXXXXXXXXXXX--XX--X---XXXXXXXXXXXXXXXXXXXXXXXXXXXXXXXXXX