----------------------------------------------------------------------------------------------------
----------------------------------------------------------------------------------------------------
---SSS--[]SSSSSSSSSSSSSSSS--------------------------------S-------------------------xxxx------------
--------[]SSSSSSSSSSSSSSSS--------------------XXXXXXXXXX--S------------------------xx---x-------xxx-
--------[]SSSSSSSSSSSSSSSS-------------------XX-----------S----------------xxx----xx-----x-xxxxxx--x
---QQ---[]SSSSSSSSSSSSSSSS------------------XXX-----------S---------------xx--x--xx-------xx---XX---
x-------[]SSSSSSSSSSSSSSSS-----------------XXXX-----------S--------------xx-E--xxx--------XX--------
-x------[]SSSSSSSSSSSSSSSS----------------XXXXX-----------S-------------xx-----XXX------------------
E-x------]SSSSSSSSSSSSSSSS---------------XXXXXX-----------S---------xxxxx---------------------------
>--xxxxx-]SSSSSSSSSSSSSSSS---------E----XXXXXXX-----------S--------xx-XXX-------o-------------------
]--SSSSSSSSSSSSSSSSSSSSSSS---E----<>---XXXXXXXX----<>-----S-------xx------------o-------------------
S--SSSSSSSSSSSSSSSSSSSSSSS--<>----[]--XXXXXXXXX----[]-----S-----oxx---------------------------------
S--SSSSSSSSSSSSSSSSSSSSSSS--[]----[]-XXXXXXXXXX----[]-----Sxxxxxxx----------------------------------
X--XXXXXXXXXXXXXXXXXXXXXXX--XX----XXXXXXXXXXXXXXXXXXXXXXXXXxXXXXXX----------------------------------