----------------------------------------------------------------------------------------------------
--------------------------------------------xxx-----------------------------------------------------
-------------------------------------------xx--x----------------------------------------------------
------------------------------------------xx----xx--------------------------------------------------
-----------------------------------------xx-----E-xxxxxx--------------------------------------------
-------------------------S----S--------xxx---------x----x-------SSSSSS----------XXXXXXXXXXXXXXX-----
--------------------------------------xx-S--------<>-----x--------------------------[]------[]------
-------------------------------------xx-----------[]------xxxx-------xxx------------[]------[]------
-xxxx-------------------xxxx--------xx------------[]-------xB-xxxxxxxx--x-----------[]------[]------
xxX--x-----------------xx<>-x------xx-------X-----XX-------XXXXESSSSSS---x----------[]------[]------
x-X---x---------------xx-[]--x----xxE---------------------XXXXXX----------x---------<>------<>-----x
--X----x-------------xx--[]---x--xx<>--------------------XXXXXXX-----------x--------xxx-----xxx---xx
-EX-----xxxxxxxxxxxxxx---[]----xxx-[]-----X-------------XXXXXXXX----------B-xxxxxxxxxE-xxxxxxE-xxxx-
XXXXX---XXEXXXXXXXXXXXXXXXXXXXXXXXXXXXXXXXX-------------XXXXXXXXXXXXXXXEXXXXXXXXXXXXXX-XXXXXXX-XXXXX