------------------------------------------------E---------------------------------------------------
-----------------------------------------------<>-------------------------------------------------xx
SSSSSSSSSSSSSSSSSSSSSSSSSSSSSSSSSSSSSSSSSSS----[]SSSSSSSSSSSSSSSSSSSSSSSSSSSSSSSSSSSSSSSS--------xxS
----------SSSSSSSSSSSSSSSSSSSSSSSS-------------[---------SSSSSSSSSSSSSSSSSSSSSSS----------------xx--
----------SSSSSSSSSSSSSSSSSSSSSSSS-----------XXX---------SSSSSSSSSSSSSSSSSSSSSSS-----------XXX-xx---
----------SSSSSSSSSSSSSSSSSSSSSSSS--QQ------xxxx---------SSSSSSSSSSSSSSSSSSSSSSS--QQ------xxxx-xSSS-
-------------------------------------------xx---x----------------------------------------xx---xx----
-----------------xxx-------------xxx-xxx--xx-----x--------------xxx------------xxx-xxx--xx-----xS---
----------xxxxxxxx?-xxxxxxxxxxxxxx--xx--xxx-------x------xxxxxxxx?-xxxxxxxxxxxxx--xx--xxx------S-S--
---------xx-SSSSSS??SSSSSSSSSSSSSS--QQ--QQQ--------x----xx-SSSSSS??SSSSSSSSSSSSS--QQ--QQQ---------S-
--------xx--SSSSS---SSSSSSSSSSSSSS------------------x--xx--SSSSS---SSSSSSSSSSSSS--------------------
xxxx---xx---SSSSS---SSSSSSSSSSSSSS-------------------xxx---SSSSS---SSSSSSSSSSSSS--------------------
?---xxxx---------oooSSSSSSSSSSSSSS--------------------x---------oooSSSSSSSSSSSSS--------------------
XX--XXXX---XXXXXXXXXXXXXXXXXXXXXXXXXXXXXXXX--------XXXX---XXXXXXXXXXXXXXXXXXXXXXXXXXXXXXX------XXXXX