----------------------------------------------------------------------------------------------------
----------------------------------------------------------------------------------------------------
--------------------------------------------------------------------------------------oo------------
---------------------------------------------------------------------------------------------------x
----------------------------------------------------xxxxx---------------------------------------xxxx
----------------------E--------------------------E-xxXXX-x----------------------------XXX------xx-XX
--------------------------------------------------xxXXXX--x-----------------------------------xx----
----------------------xxxxx----xxxxx-------------xxXXXXX---x---------------------------------xx-----
-------xxxx---------xxx----x-xxx----x----------xxxXXXXXX----x---------------------------xxxxxx------
------xx<>-x-------xx<>-----xx<>-----xx-------xx<>XXXXXX-----x-----------------XXXX----xxXXXXX------
-----xx-[]--x-----xx-[]----E<>[]----<>-x-----xx-[]XXXXXX------x-----------------------xx------------
x---xx-S[]---x---xx--[]---<>[][]----[]--x---xx-X[]XXXXXX-------xxx-------xxx---xxx---xx-------------
-xxxx--S[]----xxxx---[]---[][][]----[]---xxxx-XX[]XXXXXX-------XX-xxxxxxxx--xxxx--xxxx--------------
XXXXXXXXXXXXXXXXXXXXXXXXXXXXXXXXXXXXXXXXXXXXXXXXXXXXXXXXXXXXXXXXXXXXXXXXXX--XXXX--XXXX---------XXXX-