----------------------------------------------------------------------------------------------------
---------------------------------------------------------------------------------xxxxx--------------
-------------------------------------------------------oo-----------------------xx----x-------------
-------------------------------------------------------------------xxx-----xxx--xQ-----xx-----------
--------------------xxxxx---------------------------------------xxxx-oxoooxx--xxx-----XX-x----------
-----------------E-xxXXX-x-----------------------------XXX-----xx-XX---x-xx----x----------x-----XXoo
------------------xxXXXX--x-----------------------------------xx--------xx-----XX----------x--------
-xxx-------------xxXXXXX---x---------------------------------xx---------XX------------------x--xxxxx
xx--x----------xxxXXXXXX----x----------------------------xxxxx-------------------------------xxx----
<>---xx-------xx<>XXXXXX-----x------------------XXXX----xxXXXX----------------------------XXXXXX----
[]--<>-x-----xx-[]XXXXXX------x------------------------xx-------------------------------------------
[]--[]--x---xx-X[]XXXXXX-------xxx--------xxx---xxx---xx-------------------XXXXX--------------------
[]--[]---xxxx-XX[]XXXXXX-------XX-xxxxxxxxx--xxxx--xxxx---------------------------------------------
XXXXXXXXXXXXXXXXXXXXXXXXXXXXXXXXXXXXXXXXXXX--XXXX--XXXX--------XXXX--XXXX---------------------------