----------------------------------------------------------------------------------------------------
----------------------------------------------------------------------------------------------------
-------------------------------------------------------oo---------SSSSSSSSSSSSSSSSSSSSSSSSSSSSSSSSSS
-----------------------------------------------------------------------SSSSSSSSSSSSSSSSSSSSSSSSSSSS-
---------------------xxxxx---------------------------------------------SSSSSSSSSSSSSSSSSSSSSSSSSSSS-
------------------E-xxXXX-x----------------------------XXX-------------SSSSSSSSSSSSSSSSSSSSSSSSSSSS-
-------------------xxXXXX--x------------------------------------------------------------------------
xxxxx-------------xxXXXXX---x-------------------------------------------------xxx-----------------xx
x----x----------xxxXXXXXX----x---------------------------xxxx----------xxxxxxxx?-xxxxxxxxxxxxxxxxxx-
>-----xx-------xx<>XXXXXX-----x-----------------XXXX----xxXX-x--------xx-SSSSSS??SSSSSSSSSSSSSSSSSS-
]----<>-x-----xx-[]XXXXXX------x-----------------------xx-----x------xx--SSSSS---SSSSSSSSSSSSSSSSSS-
]----[]--x---xx-X[]XXXXXX-------xxx--------xxx--xxx---xx-------x----xx---SSSSS---SSSSSSSSSSSSSSSSSS-
]----[]---xxxx-XX[]XXXXXX-------XX-xxxxxxxxx--xxx--xxxx---------xxxxx---------oooSSSSSSSSSSSSSSSSSS-
XXXXXXXXXXXXXXXXXXXXXXXXXXXXXXXXXXXXXXXXXXXX--XXX--XXXX-------XXXXXXX---XXXXXXXXXXXXXXXXXXXXXXXXXXXX