---------------------------------------------------------------------------------------------xxx----
------------------------------------------------------------------xxxxxxxxxxxxxxxxxxxxxxxxxxxx--x---
------------------------------------------------------------------xXXXXXXXXXXXXXXXXXXXXXXXXXXX---x--
----------------------------xxx----------------------------------xxXXXXXXXXXXXXXXXXXXXXXXXXXXX----x-
------------------xxxx----xxx--x--------------------------------xx-XXXXXXXXXXXXXXXXXXXXXXXXXXX-----x
E----------------xx---x--xxXS---x-------------------------------xS-XXXXXXXXXXXXXXXXXXXXXXXXXXX------
>---------------xx-----xxxEX-----x------------------------------x--XXXXXXXXXXXXXXXXXXXXXXXXXXX------
]--------------xx-------xXXX------x----------------------------xx--XXXXXXXXXXXXXXXXXXXXXXXXXXX------
]------------xxx--------XXXXS------x--------------------------xxS--XXXXXXXXXXXXXXXXXXXXXXXXXXX------
QQQQQ-------xx<>-------XXXXX--------x---------BSS-------------x----XXXXXXXXXXXXXXXXXXXXXXXXXXX------
-----------xx-[]------XXXXXX---------x--------b--------------xx----XXXXXXXXXXXXXXXXXXXXXXXXXXX------
----------xx--[]-----XXXXXXX----------x-------B-------------xx---E-XXXXXXXXXXXXXXXXXXXXXXXXXXX------
xxxxxxxxxxx---[]----XXXXXXXX---------X-xxxxxxxxxxxxxxxxxxxxxx------XXXXXXXXXXXXXXXXXXXXXXXXXXX------
XXXXXXXXXXXXXXXXXXXXXXXXXXXXXXXXXXXX-XXXXXXXXXXXXXXXXXXXXXXXXXXXXXXXXXXXXXXXXXXXXXXXXXXXXXXXXX--XXXX