----------------------------------------------------------------------------------------------------
----------------------------------------------------------------------------------------------------
----------------------------------------------------------------------------------------------------
----------------------------------------------------------------------------------------------------
----------------------------------------------------------------------------------------------------
----------------------------------E-xxxx---------------------------------------------xxxxS-------SSS
-----------------------------------xxXXXxx------------------------------------------xx--xxx---------
-------xxxxx----xxxxx-------------xxXXXXX-x----------------------------------------xx------x-xxx----
-o---xxx----x-xxx----x----------xxxXXXXXX--x--------------------------------------xx----E-EExx--xx--
----xx<>-----xx<>-----xx-------xx<>XXXXXX---x--------------------E--S------------xxX--------XX-XX-x-
---xx-[]----E<>[]----<>-x-----xx-[]XXXXXX----x------------------<>---------E----xxXXX-------XX-XX--x
--xx--[]---<>[][]----[]--x---xx-X[]XXXXXX-----xxx-------xxx---------------<>---xxXXXX-------XX-XXX--
xxx---[]---[][][]----[]---xxxx-XX[]XXXXXX-----XX-xxxxxxxx--xxxxxxxxxxxxxxxxxxxxxXXXX--------X--XXX--
XXXXXXXXXXXXXXXXXXXXXXXXXXXXXXXXXXXXXXXXXXXXXXXXXXXXXXXXX--XXXXXXXXXXXXXXXXXXXXXXXXX--------X--XXXXX