----------------------------------------------------------------------------------------------------
----------------------------------------------------------------------------------------------------
----------------------------------------------------------------------------------------------------
----------------------------------------------------------------------------------------------------
---xx--xxx---------------------------------------------------------xxxxx----------------------------
--xx-xxx--x-----------------------------------------------------E-xxXXX-x---------------------------
-xx---<>---xxxxx-------------------------------------------------xxXXXX--x--------------------------
xx----[]---XXXX-x--------------------xxxxx----xxxxx-------------xxXXXXX---x-------------------------
x-----[]--XXXXX--x-----------------xxx----x-xxx----x----------xxxXXXXXX----x------------------------
------XXXXXXXXX---x--------SSS----xx<>-----xx<>-----xx-------xx<>XXXXXX-----x-------------------XXXX
---------XXXXXX----x-------------xx-[]----E<>[]----<>-x-----xx-[]XXXXXX------x----------------------
--------XXXXXXX-----xxx---------xx--[]---<>[][]----[]--x---xx-X[]XXXXXX-------xxx---------xxx---xxx-
E------XXXXXXXX-----XX-xxxxxxxxxx---[]---[][][]----[]---xxxx-XX[]XXXXXX-------XX-xxxxxxxxxx--xxxx--x
XXXXXXXXXXXXXXXXXXXXXXXXXXXXXXXXXXXXXXXXXXXXXXXXXXXXXXXXXXXXXXXXXXXXXXXXXXXXXXXXXXXXXXXXXXX--XXXX--X