----------------------------------------------------------------------------------------------------
----------------------------------------------------------------------------------------------------
----------------------------------------------------------------------------------------------------
------------------------------------------------------------------------------------------------xxxx
-------------------------------------------------------------------------------------xxxxxxxx--xx---
XX-----------------------QQQ?QQQQQQQQ?QQQQ-----------------------------------SSS----xx---x---x-x----
[]-----------------------------------------------------xxxx------------------------xx---<>----x>----
[]----------------------------------------------------xxXX-x-------------xxxxxxxxxxx----[]----[]----
[]---------------------------------------------------xxXXX--x----------xxx----x---<>----[]----[]----
<>SSSSSS-------------------SSSSSSSSSSS--------------xxXXXX---x--------xx<>---SS---[]----XX----XX----
---------------------------------------------------xxXXXXX----x------xx-[]--------[]----------------
-Exxx---------------------E---E-------------<>-----xXXXXXX-----x----xx--[]--------[]----------------
xxxE-xxxxxxxxxxxxxxxxxxxxxxxxxxxxxxxxxxE----[]-----XXXXXXX------xxxxx---[]--------[]----------------
XX<>XXXXXXXXXXXXXXXXXXXXXXXXXXXXXXXXXX<>----XXXXXXXXXXXXX--XXXXXXXXXXXXXXXXXXXXXXXXXXXXXXXXXXXXXXXXX