----------------------------------------------------------------------------------------------------
----------------------------------------------------------------------------------------------------
----------------------------------------------------------------------------------------------------
----------------------------------------------------------------------------------------------------
----------------------------------------------------------------------------------------------------
-------------------------------------------------------------------------E-E-E------------S--------x
------------------------------------------------------------------------<><><>--------------------xx
------------------------------------------------------------------------[][][]-------------------xx-
---xxx--------------------------------------------------------------Q?--QQQQQQ--------------xxxxxx--
--xx--x----------------------------------------xxx-------------------------------------Q--xxx---<>--
-xx----x-------------xxxx---------------------xxX-x-------------------------------xxxx---xx<>---[]--
xx------xxx---------xx<>-x------xxxxx-xxx----xx-X--x-----------------xxx---------xx<>-x-xx-[]---[]--
x-------XX-xxxxxxxxxx-[]--xxxxxxx----xx--xxxxx--X---xxxxxxxxxxxxxxxxxx--xxxxxxxxxx-[]--xx--[]---[]--
X------XXXXXXXXXXXXXXXXXXXXXXXXXX---XXX--XXXXXXXX--XXXXXXXXXXXXXXXXXXX--XXXXXXXXXXXXXX-XXX-XX--XXXXX