----------------------------------------------------------------------------------------------------
----------------------------------------------------------------------------------------------------
----------------------------------------------------------------------------------------------------
----------------------------------------------------------------------------------------------------
----------------------xxx--------------xxx--------------xxx---------------------xxxx----------------
---------xxxx--------xx--x------------xx--x------------xx--x-xxx---------------xxXX-x---------------
--------xx---x------xx----x----------xx----x----------xx-E--xx--x-------------xx-XX--x--------------
-------xx-----x----xx------xxxxx----xx------xxxxx----xx-----XX---x-----------xxXXXX---x-------------
---xxxxx-------xxxxx--------x---xxxxx--------x---xxxxx------------x---------xx-XXXX----x------------
--xx-XXX-------XXXXX--------X---XXXXX--------X---XXXXX-------o-----x-------xxXXXXXX-----x--------S--
-xx----------------------------------------------------------o--XX--x-----xx-XXXXXX------x----------
xx-------------------------------------------------------------------x---xx--XXXXXX-------xxx-------
XX--------------------------------------------------------------------xxxx---XXXXXX-------XX-xxxxxxx
X--------------------------------------------------------------------XXXXXXXXXXXXXXXXXXXXXXXXXXXXXXX