----------------------------------------------------------------------------------------------------
----------------------------------------------------------------------------------------------------
----------------------------------------------------------------------------------------------------
----------------------------------------------------------------------------------------------------
--------------------------------------------------------------------------xx---------xxxxx----------
---------------------------------------------------SSSS-----SSSSS--------xx-x-----xxxx--X-x---------
-------------------E------------------------------S----------[]---------xx---x---xx--E--X--x--------
------------------<>-----------------------------SS----------[]---------x-----x-xx---XX-X---x-------
--------xxxxxx----[]----------------------------SSS------?---[]-------xxx------xx----XX-X----x------
-------xxXSSS-x---XX-----xxx-------------------SSSS----------<>------xx<>------<>----XX-X-----x-----
-E----xx-X-----x--------xxX-x---------------------------------------xx-[]------[]----XX-X------x----
->---xx--X------x----B-xx-X--x--------xxx-----xxx---------xxx-E----xx--[]------[]----XX-X-------SSS-
xxxxxxE-EX-------xxxxxxx--X---xxxxxxxxxE-xxxxxxB-xxxxxxxxxxB-xxxxxxx---[]------[]----XX-X-------xxxx
XXXXXXXXXXXXXX---XXXXXXX--XXXXXXXXXXXX<>XXXXXXXXXXXXXXXXXXXX-XXXXXXXEXXXX------XX-XXXXX-XXXXXXXXXXXX