----------------------------------------------------------------------------------------------------
----------------------------------------------------------------------------------------------------
-------------------------------------------------------------?--------------------------------------
----------------------------------------------------------------------------------------------------
------------------------------------------------------------------------------xxxxx-----------------
--------------------------------------------SSSSS-------------------xxxxx----xxXX--x----------------
---------------------------------------------------------------SS--xx----x--xxXXX---x---------------
------------------------------------------------------------------xxX-----xxxXXXX----x--------------
---B-----------------------------------------E-------------SS----xxXX------xXXXXX-----x-------------
---b------------------------------------E--SSSSSS-xxx-----------xxXXX------XXXXXX------x------------
B------?QQQ----------------------------<>--------xxX-x--B------xxXXXX-----XXXXXXX-------x-----------
b-------------xxx-------xxxx------xxxxx[]x------xx-X--x-b----xxxXXXXX----XXXXXXXX--------xx---------
xxxxxxxxxxxxxxx--xxxxxxxx---xxxxxxx----[]-xxxxxxx--X---xxxxxxx-XXXXXX---XXXXXXXXX--------X-xxxxxxxxx
XXXXXXXXXXXXXXX--XXXXXXXX---XXXXXXX--X-XXXXXXXXXXXXXXXXXXXXXXX-XXXXXXXXXXXXXXXXXXXXXXXXXXXXXXXXXXXXX