----------------------------------------------------------------------------------------------------
----------------------xxxxxxxxxxxxxxxxxxxxxxxxxxxxxxxxxxxxxxxxxxxxxxxxx-----------------------------
SSSSSSSSSSSSS--------xxSSSSSSSSSSSSSSSSSSSSSSSSSSSSSSSSSSSSSSSSSSSSSSS-x------------SSSSSSSSSSSSSSSS
SSSS----------------xx--------------------------------------------------x-------------[]----[]------
SSSS-----------XXX-xx----------------------------------------------------x------------[]----[]------
SSSS--QQ------xxxx-xSSS------------E--------------------------------------x-----------[]----[]---QQQ
-------------xx---xx--------------<>---------------------------------------x----------<>----[]------
---xxx-xxx--xx-----xS-------------[]----------------------------------------x---------------[]------
xxxx--xx--xxx------S-S------------[]-------S----------------------E----------x--------------[]--xxxx
SSSS--QQ--QQQ---------S------E--SS[]SS---E----E------------------<>-----------x-------------[]-xxSSS
SSSS------------------------<>----[]----<>---<>---------------XX-[]--XXX-------x------------<>xx-SSS
SSSS------------------------[]----[]----[]---[]--------------XXX-[]--XXX--------x----xxx-----xx--SSS
SSSS------------------------[]-E--[]----[]---[]----------E-E-XXX-[]--XXX-------X-xxxxx--xxxxxx---SSS
XXXXXXXXXXXXX------XXXXXXXXXXXXXXXXXXXXXXXXXXXXXXXXXXXXXXXXXXXX--XX--XX------XXXXXXXXX--XXXXXXE--XXX