----------------------------------------------------------------------------------------------------
----------------------------------------------------------------------------------------------------
----------------------------------------------------------------------------------------------------
----------------------------------------------------------------------------------------------------
----------------------------------------------------------------------------------------------------
SSSX---------------------------------------------------------xxxx------------------XX---------------
-------------------------------------------------------------x<>-x-----------------[]---------------
-------------------------------------------------------------x[]--x----------------[]---------------
---------------X-EE----X-------------ooo---------------E----xx[]---x----xxxx-------[]---------------
SSSSS----------XSSSSSSSX-------------ooo-------------------xxS[]----x--xx---xx-----<>SSSSSS---------
---------------------------------------------------oo-----xx--[]-----xxx----X-x---------------------
----------xxx--------------------------------------oo----xx---[]------x-----XX-xx---Exxx------------
xxxxxxxxxxx--xxxxxxxxxxxxxxxxxxxxxxxxxxxxxxxxxxxxxxxxxxxxx----[]------B-----XXXX-xxxxxE-xxxxxxxxxxxx
XXXXXXXXXXX--XXXXXXXXXXXXXEEXEXXXXXXXXXXXXEEXXXXXXXXXXXXXXXXXXXXXXXXXXX-----XXXXXXXXX<>XXXXXXXXXXXXX