----------------------------------------------------------------------------------------------------
----------------------------------------------------------------------------------------------------
---------------------------xxx-----xxxx-----xx------------------------------------------------------
--------------------------xx--x---xx---x-?-xx-x------xxx----xxx-------------------------------------
-------------------xxx---xx----x-xx-----x-xx---x-xxxxx--xxxxx--x-----xx--oo--oo---------------------
------------------xx--x-xx------xx-------xx-----xx--XX--XXXXX---xoo-xx-x-------------------xxxE-----
-----------------xx-E--xx-------XX-------XX-----XX---------------x-xx---x----------xxxxxxxxx--x-----
----------------xx-----XX-----------------------------------------xx-----x--------xxXXXXXXXX---x---x
----------xxxxxxx-------------------------------------------------XX------xxx----xx-------------xxxx
---------xx-XXXXX-------o-------------------------------------------------XX-x--xx--------------XXXX
--------xx--------------o--XX-------------------------------------------------xxx-------------------
S------xx---------------------------------------------------------------------XXXX------------------
xxxxxxxx-------------------------------------------------------------------------------------ooo----
XXXXXXXX------------------------------------------------XXXXXXXX-----------------------------XXX----