----------------------------------------------------------------------------------------------------
----------------------------------------------------------------------------------------------------
----------------------------------------------------------------------------------------------------
----------------------------------------------------------------------------xxx---------------------
--------------------------------------------------------------------------xxx--x--------------E-----
-------------------------------------------------------------------------xxXX---x-----E-SSSSS-------
------------------------------------------------------------------------xxXXX----x-E----------------
--------------------------------------------------------------------xxxxxXXXX-----x-----------------
-------------------------------------------------------------------xx--xXXXXX------x----------------
-----------------------------ooo----------------------------------xx---XXXXXX-------x----SSS--------
-----------------------------------------------------------------xx----XXXXXX--------x--------------
---Exxx-----------xxxx---------xxx-----xxxx--------------xxxxxx-xx-----XXXXXX---------x-------------
xxxxx--xxxxxxxxxxxxEE-xxxxxxxxxx--xxxxxxEE-xxxxxxxxxxxxxxx--EE-xxX-----XXXXXX----------xxxxxxxxxxxxx
XXXXX--XXXXXXXXXXXXXXXXXXXXXXXXX--XXXXXXXXXXXXXXXXXXXXXXXX--XXXXXX-----XXXXXX----------XXXXXXXXXXXXX