----------------------------------------------------------------------------------------------------
----------------------------------------------------------------------------------------------------
----------------------------------------------------------------------------------------------------
----------------------------------------------------------------------------------------------------
---------------------------------------E------------------------------------------------------------
-----------------------------------SSSSSSSSSS-------------------------------------------------------
----------------------------------------------------------------------------------------------------
----------------------------------------------------------------------------------------------------
B--------------------------------------------------X------------------------------------------------
b------------------------------------xxx---SSSSSSSSX-------------------------xxx--------------------
----?QQ-----------------------------xxX-x-----------------------------------xxX-x-------------------
x------------------xxx------xxxxx--xx-X--x-------------------------------B-xx-X--x------------------
-xxxxxxxxxxxxxxxxxxx--xxxxxxx----xxx--X---xxxxxxxxxxxxxxxxxxxxxxxxxxxxxxxxxx--X---xxxxxxxxxxxxxxxxxx
XXXXXXXXXXXXXXXXXXXX--XXXXXXX--X-XXXXXXXXXXXXXXXXXXXXXXXXXXXXXXXXXXXXXXXXXXX--XXXXXXXXXXXXXXXXXXXXXX