----------------------------------------------------------------------------------------------------
----------------------------------------------------------------------------------------------------
---------------------?------------------------------------------------------------------------------
----------------------------------------------------------------------------------------------------
--------------------------------------xxxxx---------------------------------------------------------
----SSSSS-------------------xxxxx----xxXX--x----------------------------------XX--------------------
-----------------------SS--xx----x--xxXXX---x---------------------------------XX--------------------
--------------------------xxX-----xxxXXXX----x----------------------------xxx-XX--------------------
-----E-------------SS----xxXX------xXXXXX-----x--------------------------xxXx-XX--------------------
----SSSSS-xxx-----------xxXXX------XXXXXX------x------------------------xxXX--XX--------------------
xx-------xxX-x--B------xxXXXX-----XXXXXXX-------x--------------E------ExxXXX-xXX--------------------
>-x-----xx-X--x-b----xxxXXXXX----XXXXXXXX--------xx-------------------xxXXXX--x--------xxx--------xx
]--xxxxxx--X---xxxxxxx-XXXXXX---XXXXXXXXX--------X-xxxxxxxxxxxxxxxxxxxxXXXXX---xxxxxxxxxX-xxxxxxxxx-
XXXXXXXXXXXXXXXXXXXXXX-XXXXXXXXXXXXXXXXXXXXXXXXXXXXXXXXXXXXXXXXXXXXXXXXXXXXXXXXXXXXXXXXXXXXXXXXXXXX-