----------------------------------------------------------------------------------------------------
----------------------------------------------------------------------------------------------------
----------------------------------------------------------------------------------------------------
----------------------------------------------------------------------------------------------------
----E-----------------------------------------------------------------------------------------------
SSSSSSSSSS--------------------------------------------------?----------SSS----SQQS---------oo-------
---------------------------------------------------------------------------------------------------X
-----------------------------------------------------------------------------------------xxxx-------
---------------X----------------------------------------------------------------------xxxx---xxxxx--
--xxx---SSSSSSSX-----------------------------------------Q--Q-------S----------SS----xxXXX---XXXX-x-
-xxX-x--------------------------------------------------------B---------------------xxXXXX---------x
xx-X--x-------------------------------------------------------b--------------------xxXXXXX----------
x--X---xxxxxxxxxxxxxxxxxxxxxxxxxxxxxxxxxxxxxxxxxxxxxxxxxxxxxxxxxxxxxxxxxxxxxxxxxxxxxXXXXXX----------
XXXXXXXXXXXXXXXXXXXXXXXXXXXXXXXXXXXXXXXXXXXXXXXXXXXXXXXXXXXXXXXXXXXXXXXXXXXXXXXXXXXXXXXXX-----------