----------------------------------------------------------------------------------------------------
----------------------------------------------------------------------------------------------------
SSSSSSSSSSSSSSSSSSSSSSSSSSSSSSSSSSSSSSSSSSSSSSSSSSSSSSSSSSSSSSSSSSSSSSSSSSSSSSSSSSSSSSSSSSSSSSSSSSSS
SS-------------------SSSSSSSSSSSSSSSSSSSSSSSSS--------------------------SSSSSSSSSSSSSSSSSSSSSSSSS---
SS-------------------SSSSSSSSSSSSSSSSSSSSSSSSSxxx-----------------------SSSSSSSSSSSSSSSSSSSSSSSSS---
SS-------------------SSSSSSSSSSSSSSSSSSSSSSSSSx?-x----------------------SSSSSSSSSSSSSSSSSSSSSSSSS---
----------------------------------------------o---xxxxxx--------------------------------------------
----------------------------xxx---------------o---SSSSS-x---------------------------xxxxx------xxxxx
---------------------xxxxxxxx?-xxxxxxxxxxxxxxxx---SSSSS--xxxxxxxxxxxxxxxxxxxxxxxxxxxx----xxxxxxxE--<
xx------------------xx-SSSSSS??SSSSSSSSSSSSSSSS?--SSSSS?SS?SSSSS????????SSSSSSSSSSSS?----SSSSSSSS--[
B-x----------------xx--SSSSS---SSSSSSSSSSSSSSSS]----------SSSSSSSSSSSSSS---------------------------[
b--x-------xxx-xxxxx---SSSSS---SSSSSSSSSSSSSSSS]----------SSSSSSSSSSSSSS--------------<>-----------[
BEE-xxxxxxxx--xx--x---------oooSSSSSSSSSSSSSSSS]--------------------------------------[]-----------[
XXXXXXXXXXXX--XX--X---XXXXXXXXXXXXXXXXXXXXXXXXXXXXXXXXXXXXXX-XX-XXXXXXXXXXXXXXXXXXXXXXXXXXXXXXXXXXXX