----------------------------------------------------------------------------------------------------
----------------------------------------------------------------------------------------------------
----------------------------------------------------------------------------------------------------
----------------------------------------------------------------------------------------------------
------------------------------------------E---------------------------------------------------------
--------------------------------------SSSSSSSSSS--E-------------------------------------------------
----------------------------------------------------------------------------------------------------
---------------------------------------------------------------------------------------B------------
---B------------------------------------------------X----------------------------------b------?-----
---b------------------------------------xxx---SSSS?SX---------QQQQ-------------------SSXSS-------ESS
B------?QQ-----------------------------xxX-x-------------------------B-----E---B--------------------
b---------------------xxx------xxxxx--xx-X--x--------------B--E------b---------b-----------B--------
xxxxxxxxxxxxxxxxxxxxxxx--xxxxxxx----xxx--X---xxxxxxxxxxxxxxxxxxxxxxxxxxxxxxxxxxxxxxxxxxxxxxxxxxxxxxx
XXXXXXXXXXXXXXXXXXXXXXX--XXXXXXX--X-XXXXXXXXXXXXXXXXXXXXXXXXXXXXXXXXXXXXXXXXXXXXXXXXXXXXXXXXXXXXXXXX