----------------------------------------------------------------------------------------------------
----------------------------------------------------------------------------------------------------
E---------------------------------------------------------------------------------------------------
----------------------------------------------------------------------------------------------------
-------------------------------------------------------------------------------E--------------------
-------------------?SS-----------------------------------------------------SSSSSS-------------------
----------------------------------------------------------------------------------------------------
--------------------------------------------------------B-------------------------------------------
--------------------------------------------------------b-------------------E-----------------------
-------------------------------QQQ--------------------SSXSS-------xxxxx---SSSSSSS---xxx-------------
----------------E---B----------------B------E---B----------------xx-<>-x-----------xxX-x------------
xxx--------B--------b-------B--E-----b----------b-----------B---xx--[]--x---------xx-X--x-----------
XX-xxxxxxxxxxxxxxxxxxxxxxxxxxxxxxxxxxxxxxxxxxxxxxxxxxxxxxxxxxxxxx---[]---xxxxxxxxxx--X---xxxxxxxxxxx
XXXXXXXXXXXXXXXXXXXXXXXXXXXXXXXXXXXXXXXXXXXXXXXXXXXXXXXXXXXXXXXXX--XXXXXXXXXXXXXXXXXXXXXXXXXXXXXXXXX