----------------------------------------------------------------------------------------------------
----------------------------------------------------------------------------------------------------
----------------------------------------------------------------------------------------------------
----------------------------------------------------------------------------------------------------
----------------------------------------------------------------------------------------------------
-------------------------------------------------------S------------------E------E------------------
----------EX-----------------------------------------------------------E----------------------------
-------X---X-------------------------------------------------------xxxxxxxxxxxxxxx------------------
-------X---X--------X-EE----X------------ooo----------------------xxXSSSSSSSSSSSS-x-------------xxxx
--[S---XSS?X--------XSSSSSSSX------------ooo-----------S---------xxXX--------------x--------QQ-xx-X-
----------------------------------------------------------------xxXXX----oooooo-----x---------xx--X-
----------------xxx--------------------------------------------xxXXXX----------------xxxx----xx---X-
xxxxxxxxxxxxxxxxx--xxxxxxxxxxxxxxxxxxxxxxxxxxxxx-xxxxxxxxxxxxxxxXXXXX----oooooo-------x--xxxxx----X-
XXXXXXXXXXXXXXXXX--XXXXXXXXXXXXEEXEXXXXXXXXXXXEEXEXXXXXXXXXXXXXXXXXXXXXXXXXXXXXXX-----X--XXXXX--XXXX