----------------------------------------------------------------------------------------------------
----------------------------------------------------------------------------------------------------
----------------------------------------------------------------------------------------------------
----------------------------------------------------------------------------------------------------
----------------------------------------------------------------------------------------------------
----------------------------------------------------------xxxx------------------XX------------------
X---------------------------------------------------------x<>-x-----------------[]------------------
X---------------------------------------------------------x[]--x----------------[]------------------
X----------X-EE----X-------------ooo----------------E----xx[]---x----xxxx-------[]------------------
X----------XSSSSSSSX-------------ooo--------------------xxS[]----x--xx---xx-----<>------------------
------------------------------------------------oo-----xx--[]-----xxx----X-x------------------------
-------xxx--------------------------------------oo----xx---[]------x-----XX-xx---Exxx---------------
xxxxxxxx--xxxxxxxxxxxxxxxxxxxxxxxxxxxxxxxxxxxxxxxxxxxxx----[]------B-----XXXX-xxxxxE-xxxxxxxxxxxxxxx
XXXXXXXX--XXXXXXXXXXXXEEXEXXXXXXXXXXXXEEXEXXXXXXXXXXXXXXXXXXXXXXXXXX-----XXXXXXXXX<>XXXXXXXXXXXXXXXX