----------------------------------------------------------------------------------------------------
----------------------------------------------------------------------------------------------------
----------------------------------------------------------------------------------------------------
----------------------------------------------------------------------------------------------------
----------------------------------------------------------------------------------------------------
----------------------------------SSSSS----QXX---------------XXXXXXXXXXXXXXXX-----------------------
-----ES--------------E------------------------------------------------------------------------------
-----------QQQ------<>------------------------------------------------------------------------------
--------------------[]-------------------------------------------------------------------------x-x--
-----------------QQQQQQQQQQ--------QQQQ--SQQ---------------------------------------------------xx-x-
xx---------------------------------------------------------------------------------------------xB--x
B-x----------xxxxx-----------------xxx------------xxx-xxx---------xxx-xxx-xxx-----xxx---------xxb---
b--xxxxxxxxxxxB---xxxxxxxxxxxxxxxxxxB-xxxxxxxxxxxxx--xx--xxxxxxxxxx--xx--xx--xxxxxxE-xxxxxxxxxx-BEE-
XXXXXXXXXXXXXXX--XXXXXEEXXXXXXXXXXXXXXXXXXXXXXXXXXX--XX--XXXXXXXXXX--XX--XX--XXXXXXXXXXXXXXXXXXXXXXX