----------------------------------------------------------------------------------------------------
----------------------------------------------------------------------------------------------------
----------------------------------------------------------------------------SSSSSSSSSSSSSSSSSSSSSSSS
--------------------------------------------------------------------------------------------SS--SSSS
-----------------------------------------------------------------------------E--------------SS--SSSS
X--SSSS---------------------------------------------------------SSSSSSSSSSSSSSSSS---------SS--------
]--------------xxx--------------ES---------------E----------------------------------------SS--------
]--------------xB-x------S-------------QQQQ-----<>----------------------------------------SS--------
]---xxxx------xxb-------------------------------[]------------------xxxx-----E------X-----SS----oooo
X--xx--xx----xxXXX-xS------------------------QQQQQQQQQQ------------xx<>-x----QQ?QQQQX-----SSSS--SSSS
>-xx-----x--xxXXXX--x-----xxx-------------------------------------xx-[]--x------------------SS------
Xxx-------xxxXXXXX---x---xxB-x-----------xxxxx-------------------xx--[]---x-----------------SS------
xx---------xXXXXXX----xxxx-b--xxxxxxxxxxxxB---xxxxxxxxxxxxxxxxxxxx---[]----xxxxxxxxxxxxxxxxxxxxxxxxx
XX------S--XXXXXXXXXXXXXXXXXXXXXXXXXXXXXXXX--XXXXXEEXXXXXXXXXXXXXXXXXXXXXXXXXXXXXXXXXXXXXXXXXXXXXXXX