-----------------------------------------------------------------------------------------E----------
----------------------------------------------------------------------------------------------------
--------------------------------------------------------------------------------S-------------------
----------------------------------------------------------------------------------------------------
----------------------------------------------------------------------------------------------------
-------------XX---------------------------------------------------------------XXXX------------------
-------------[]---------------------------------------------------------------XXX-------------------
-------------[]-------------------------------------------------------------------------------------
--xxxx-------[]--------------------------------------xxxxx-xxxxx-Exxxxx--xxx---------------------ooo
-xx---xx-----<>SSSSSS----------------------------xxxxx----xx----xxx----xxx--x-----------------------
xx----X-x------------------------------E--------xx-XXX---XXX----XXX----XXX---x----------------------
x-----XX-xx---Exxx-----------------------------xx--XX----XX-----XX-----XX-----xx--------------------
?-----XXXX-xxxxxE-xxxxxxxxxxxxxxxxxxxxxxxxxxxxxxX----------------------------XX-xxxxxxxxxxxxxxxxxxxx
XX----XXXXXXXXX<>XXXXXXXXXXXXXXXXXXXXXXXXXXXXXXXX----------------------------XXXXXXXXXXXXXXXXXXXXXXX