----------------------------------------------------------------------------------------------------
----------------xxxxxxxxxxxxxxxxxxxxxxxxxxxxxxxxxxxxxxxxxxxxxxx-------------------------------------
SSSSSSS--------xxSSSSSSSSSSSSSSSSSSSSSSSSSSSSSSSSSSSSSSSSSSSSS-x--------------SSSSSSSSSSSSSSSSSSSSSS
--------------xx------------------------------------------------x----------------------------SS--SSS
---------XXX-xx--------------------------------------------------x---------------------------SS--SSS
--------xxxx-xSSS------------E------------------------------------x--------------oooo------SS-------
-------xx---xx--------------<>-------------------------------------x-----------------------SS-------
xxxx--xx-----xS-------------[]--------------------------------------x----------S-SSSS-S----SS-------
xS--xxx------S-S------------[]-------S--------------------E----------x---------SoS--SoS----SS----ooo
S---QQQ---------S------E--SS[]SS---E----E----------------<>-----------x--------SSS--SSS----SSSS--SSS
S---------------------<>----[]----<>---<>-------------XX-[]--XXX-------xxx-------------------SS-----
S---------------------[]----[]----[]---[]------------XXX-[]--XXX-------SS-x------------------SS-----
S---------------------[]-E--[]----[]---[]--------E-E-XXX-[]--XXX-------SS--xxxxxxxxxxxxxxxxxxxxxxxxx
XXXXXXX------XXXXXXXXXXXXXXXXXXXXXXXXXXXXXXXXXXXXXXXXXX--XX--XX------XXXXXXXXXXXXXXXXXXXXXXXXXXXXXXX