-------------------------------------------------xxx--------xxx---------xxxxxx----------------------
------------------------------------------------xx--x------xx--x-------xx----xxxxxxxxxxxxxxxxxxxxxxx
-----------------------------------------------xx----x----xx----x-----xx-------SSSSSSSSSSSSSSSSSSSSS
----------------------------------------------xx------x--xx------x---xx--------------------------[]-
--------------------------------------------xxx--------xxx--------xxxx---------------------------[]-
-------------------------------------------xxXX--------XXX--------XXXX---------------------------[]-
------------------------------------------xxXXX--------XXX--------XXXX------X--------------------[]-
-----------------------------------------xxXXXX--------XXX--------XXXX---------------------------<>-
----------------------------------------xxXXXXX--------XXX--------XXXX------------------------------
---------------------------------------xxXXXXXXS-------XXX--------XXXX--------------------<>--------
----------E---------------------------xxXXXXXXX--------XXX--------XXXX--------------------[]----S-S-
x-----------------xxxxxx-------------xxXXXXXXXX--------XXX--------XXXX---------oooooooo---[]----S-S-
-xxxxxxxxxxxxxxxxxxE-EE-xxxxxxxxxxxxxxXXXXXXXXX--------XXX--------XXXX---------oooooooo---[]----S-S-
XXXXXXXXXXXXXXXXXXXXXXXXXXXXXXXXXXXXXXXXXXXXXXXXX------XXX--------XXXX---------XXXXXXXX---[]----S-S-