----------------------------------------------------------------------------------------------------
----------------------------------------------------------------------------------------------------
----------------------------------------------------------------------------------------------------
----------------------------------------------------------------------------------------------------
---------------------------------------------------------oo-----------------------------------------
--------------------------------------------------------------------------------------------------XX
---------------XXXoo-----------------------E--------------------------------------------------------
----------------------X-----------------------------------------------------------------------------
-----------------------------------------------ooooo------------------------------------------------
----------------------------------------------XXXXXXX-------?-------------XXXX---XXX---XXX---XXX----
Qxxxxx----------------------------------------------------------------------------------------------
xx----x---------------------------------------------------------------------------------------------
x------xxxxxx---------------------------------------------------------------------------------------
X------XXXXX------------------XXXXXX----------------XXX-XXX-------XXXXXX----------------------------