----------------------------------------------------------------------------------------------------
----------------------------------------------------------------------------------------------------
----------------------------------------------------------------------------------------------------
----------------------------------------------------------------------------------------------------
---------------------------------------------------xxxx------------------------------------E--------
--SSS----------------------------------------------xXX-x-------------------------------SSSSSSSSSS---
---------------------------------------------------xXX--x-------------------------------------------
---------------------------------------------------xXX---x------------------------------------------
xxxxxxx-------------------------------------------xxXX----x-----------------------------------------
-XXXXX-x------------------xxx--------------------xxXXX-----x-----------------------------xxx---SSSSS
-X------x----------------xxX-x------------------xx-XXX------x---------------------------xxX-x-------
-X-------x------------B-xx-X--x----------------xx--XXX-------xxx---------xxx----xxxxx--xx-X--x------
-X--------xxxxxxxxxxxxxxx--X---xxxxxxxxxxxxxxxxxE--XXX-------XX-xxxxxxxxxx--xxxxx----xxx--X---xxxxxx
XXXX----XXXXXXXXXXXXXXXXX--XXXXXXXXXXXXXXXXXXXXXXXXXXXXXXXXXXXXXXXXXXXXXXX--XXXXX--X-XXXXXXXXXXXXXXX