----------------------------------------------------------------------------------------------------
----------------------------------------------------------------------------------------------------
----------------------------------------------------------------------------------------------------
----------------------------------------------------------------------------------------------------
----------------------------------------------------------------------------------------------------
------------------------------------------------EXX-------------------------------------------------
-----------------------------------------------EXXX----------------------------------ooo------xxx---
--------------------------------E-------------EXXXX---------------------------------------XX-xx--x--
-o-------------------------------XXX-------X--XXXXX-----------------------------------------xx----x-
o-o------------------------------------------XXXXXX----------xxxxxxxxxxxxxxxxxxxx-----XXXX-xx------x
--------------------------------------------XXXXXXX---------xxXXXXXXXXXXXXXXXXXX-x---xxxxxxx-------X
--xxx-----xxxx-----------------------------XXXXXXXX--------xxXXXXX-------------X--xxxx---XXX--------
xxx--xxxxxxEE-xxxxxxxxxxxxxxxxxx----------XXXXXXXXX-------XxXXXXXX-------------X--XXXX--------------
XXX--XXXXXXXXXXXXXXXXXXXXXXXXXXX---------XXXXXXXXXXXXXXXXXXXXXXXXX-------------X----------------XXX-