----------------------------------------------------------------------------------------------------
----------------------------------------------------------------------------------------------------
----------------------------------------------------------------------------------------------------
----------------------------------------------------------------------------------------------------
------E---------------------------------------------------------------------------------------------
-----SSSSSSS---SSSQ--------------?-----------SSS----SQQS--------------------------------------------
----------------------------------------------------------------------------------------------------
----------------------------------------------------------------------------------------------------
--E---------------------------------------------------------xxxxxx---------------------------------x
oSSSS-------------S-----SS----Q--Q--Q-----S----------SS----xxX--X-x---------------QQ------------xxxx
----------------------------------------------------------xxXX--XX-x--------------------------xxxXXX
-xxx-----xxxxx-------------------------------------------xxXXX--XXX-x--xxx-----------xxx---xxxxXXXXX
xx--xxxxxx----xxxxxxxxxxxxxxxxxxxxxxxxxxxxxxxxxxxxxxxxxxxxXXXX--XXXX-xxx--xxxxxxxxxxxx--xxxxXXXXXX--
XX--XXXXXX---XXXXXXXXXXXXXXXXXXXXXXXXXXXXXXXXXXXXXXXXXXXXXXXXXXXXXXXXXXX--XXXXXXXXXXXX--XXXXXXXX----