----------------------------------------------------------------------------------------------------
----------------------------------------------------------------------------------------------------
-------------------?--------------------------------------------------------------------------------
----------------------------------------------------------------------------------------------------
---E--------------------------------xxxxx-----------------------------------------------------------
--SSS---------------------xxxxx----xxXX--x--------------------------xxxxS-------SSS-----------------
---------------------SS--xx----x--xxXXX---x------------------------xx--xxx--------------------------
------------------------xxX-----xxxXXXX----x----------------------xx------x-xxx---------------------
E----------------SS----xxXX------xXXXXX-----x--------------------xx----E-EExx--xx-------------------
SSSSS---xxx-----------xxXXX------XXXXXX------x------------------xxX--------XX-XX-x------------------
-------xxX-x--B------xxXXXX-----XXXXXXX-------x---------S?SS---xxXXX-------XX-XX--x-----------------
------xx-X--x-b----xxxXXXXX----XXXXXXXX--------xx-------------xxXXXX-------XX-XXX--x-------xxx------
xxxxxxx--X---xxxxxxx-XXXXXX---XXXXXXXXX--------X-xxxxxxxxxxxxxxXXXX--------X--XXX--Exxxxxxxx--xxxxxx
XXXXXXXXXXXXXXXXXXXX-XXXXXXXXXXXXXXXXXXXXXXXXXXXXXXXXXXXXXXXXXXXXXX--------X--XXXXXXXXXXXXXX--XXXXXX