----------------------------------------------------------------------------------------------------
----------------------------------------------------------------------------------------------------
--S-------------------------------------------------------------------------------------------------
----------------------------------------------------------------------------------------------------
----------------------------------------------------------------------------------------------------
XXXXXX-----------------------------------------------ESSS----------------xxxx------------------XX---
-------------------------------------------------------------------------x<>-x-----------------[]---
-------------------------------------------------------------------------x[]--x----------------[]---
-------------------------------------------------------------------E----xx[]---x----xxxx-------[]---
-------------------------xxx-------------------------------------------xxS[]----x--xx---xx-----<>SSS
x------------------------xB-x---------------------E------------oo-----xx--[]-----xxx----X-x---------
-x-xxx------xxx---------xxb--x---------------------------------oo----xx---[]------x-----XX-xx---Exxx
--xx--xxxxxxxE-xxxxxxxxxx-BEE-xxxxxxxxxxxxxxxxxxxxxxxxxxxxxxxxxxxxxxxx----[]------B-----XXXX-xxxxxE-
XXXX--XXXXXXXXXXXXXXXXXXXXXXXXXXXXXXXXXXXXXXXXXXXXXXXXXXXXXXXXXXXXXXXXXXXXXXXXXXXXX-----XXXXXXXXX<>X