----------------------------------------------------------------------------------------------------
----------------------------------------------------------------------------------------------------
----------------------------------------------------------------------------------------------------
----------------------------------------------------------------------------------------------------
----------------------------------------------------------------------------------------------------
----------------------------------------------------------------------------------------------------
----------------------------------------------------------------------------------------------------
----------------------------------------------------------------------------------------------------
----------------------------------------------------------------------------------------------------
QQQQQQQ?---------------------------------QQQQ?----------------------------------SSS-----------------
--------------------------------XXXXXXXXX----------------------------XXXXXXXXXXXE-------------------
------------------?-------------------------------------?-----------------------------------------?-
-------B------E------------E-----------------B------E-----------E-----------------------B-----E-----
XEXX--XXXXXXXXXXXX-XXXXXXXXXXXXXXXXXXXXXXXX-XXXXXXXXXXXX-XXXXXXXXXXXXXXXXXXXXXXXXXXXXXXXXXXXXXXXXX-X