----------------------------------------------------------------------------------------------------
----------------------------------------------------------------------------------------------------
SSSSSSSSSSSSSSSSSSSSSSSSSSSSSSSSSSS?SSSSSSSSSSSSSSSSSSSSSSSSSSSSSSSSSSSSSSSSSSSSSSSSSSSSSSSSS-------
SS--SSSSSS--SSSS------SSSS--------------------------------SSSSSSSSSSSSSSSSSSSSSSSSSS----------------
SS--SSSSSS--SSSS--E---SSSS--------------------------------SSSSSSSSSSSSSSSSSSSSSSSSSS-----------XXX-x
--------SS---S----SS----------oooooo----------------------SSSSSSSSSSSSSSSSSSSSSSSSSS--QQ------xxxx-x
--------SS---S----SS-------------------------------------------------------------------------xx---xx
--------SS---S----SS----------SSSSSS----------------------------xxx----------------xxx-xxx--xx-----x
----ooooSS---So??-SS---E------SSSSSS----------------------xxxxxxx?-xxxxxxxxxxxxxxxxx--xx--xxx------S
SS--SSSSSS---SSS--SS--SSSS-------------------------------xx-SSSSS??SSSSSSSSSSSSSSSSS--QQ--QQQ-------
SS-------------------EE---------------X-----------------xx--SSSS---SSSSSSSSSSSSSSSSS----------------
SS-----------------------xxxxx-----XXXX---------xxx-xxxxx---SSSS---SSSSSSSSSSSSSSSSS----------------
xxxxxxxxxxxxxxxxxxxxxxxxxx----xxxxxxxxxxxxxxxxxxx--xx--x--------oooSSSSSSSSSSSSSSSSS----------------
XXXXXXXXXXXXXXXXXXXXXXXXXX---XXXXXXXXXXXXXXXXXXXX--XX--X---XXXXXXXXXXXXXXXXXXXXXXXXXXXXXXXXXX------X