----------------------------------------------------------------------------------------------------
----------------------------------------------------------------------------------------------------
----------------------------------------------------------------------------------------------------
----------------------------------------------------------------------------------------------------
---------------------------------------------------------------------------------------------E------
--------------------------------?SS------------------------------------------------------SSSSSS----S
----------------------------------------------------------------------------------------------------
----------------------------------------------------------------------B-----------------------------
----------------------------------------------------------------------b-------------------E---------
----xxx--------------------------------------QQQQ-------------------SSXSS-------xxxxx---SSSSSSS---xx
----xB-x---------------------E---B------------------B-----E---B----------------xx-<>-x-----------xx<
x--xxb--x---------------B--------b--------B--E------b---------b-----------B---xx--[]--x---------xx-[
-xxx-BEE-xxxxxxxxxxxxxxxxxxxxxxxxxxxxxxxxxxxxxxxxxxxxxxxxxxxxxxxxxxxxxxxxxxxxxx---[]---xxxxxxxxxx--[
XXXXXXXXXXXXXXXXXXXXXXXXXXXXXXXXXXXXXXXXXXXXXXXXXXXXXXXXXXXXXXXXXXXXXXXXXXXXXXX--XXXXXXXXXXXXXXXXXXX