----------------------------------------------------------------------------------------------------
----------------------------------------------------------------------------------------------------
SSSSSSSSSSSSSSSSSSSSSSSSSSSSSSSSSSSSS?SSSSSSSSSSSSSSSSSSSSSSSSSSSSSSSSSSSSSSSSSSSS------------------
-SS--SSSSSS--SSSS------SSSS-------------------------------------------------------------------------
-SS--SSSSSS--SSSS--E---SSSS---------------------------------------------------------XXX-------------
S--------SS---S----SS----------oooooo---------------------------------------------------------------
S--------SS---S----SS------------------------------------------------------------------------oo-----
S--------SS---S----SS----------SSSSSS----------------xxx---------------------------------------E----
SE---ooooSS---So??-SS---E------SSSSSSo-------------xxx--x----------------------xxxxx-----SSSSSSSSSS-
SSS--SSSSSS---SSS--SS--SSSS------------------------x<>---x------xxxx----------xxXXX-xxxx------------
-SS-------------------EE--------------------------xx[]----xxx--xxSS-x--------xxEXXX-XXX-x-----------
-SS-----------------------xxxxx------------------xx-[]----<>-xxx-SS--x------xxXXXXX------x----------
xxxxxxxxxxxxxxxxxxxxxxxxxxx----xxxxxxxxxxxxxxxxxxx--[]--E-[]--x--SS---xxxxxxxXXXXXX-------xxxxxxxxxx
XXXXXXXXXXXXXXXXXXXXXXXXXXX---XXXXXXXXXXXXXXXXXXXXXXXXXXXXXXXXX--XX--XXXXXXXXXXXXX-------XXXXXXXXXXX