----------------------------------------------------------------------------------------------------
----------------------------------------------------------------------------------------------------
----------------------------------------------------------------------------------------------------
----------------------------------------------------------------------------------------------------
----------------------------------E--------------------------------------ooo------------------------
-E-------E------------------------S--------------xxx---------------------ooo------------------------
------------------------------------------------xx--xx----------------------------------------------
xxxxxxxxxx------------------------?------------xx---X-x-----oooo---------xxxx-------xxx------------o
SSSSSSSSS-x-------------xxxx------------------xx-E--X--x----oooo--------xx---xxxxxxxx--x-----------o
-----------x--------QQ-xx-X-x----xxx---------xx--X--X---x-------------Exx---XXXXXXEXX---x----------E
ooooooo-----x---------xx--X--x--xxX-x-------xxE--X--X----xxxxxxxxxxxxxxx----X-------X----xxxxxxxxxxx
-------------xxxx----xx---X---xxx-X--x-----xx-X--X--X----XXXXXXXXXXXXXXX----X-------X---XXXEXXXXXXXX
ooooooo-------x--xxxxx----X----x--X---xxxxxx--X--X--X----X-------------X----X-------X---X--------X--
XXXXXXXXX-----X--XXXXX--XXXXXXXXXXXX-XXXXXXX--X--X--X----X-------------X----X-------X---X--------X--