----------------------------------------------------------------------------------------------------
----------------------------------------------------------------------------------------------------
----------------------------------------------------------------------------------------------------
----xxx---------------------------------------------------------------------------------------------
-xxxx--x--------------------E-----------------------------------------------------------------------
xx--X---x-----S-----------QQQQQQQ----------------E------------------------------------------------SS
x--------x----S---------------------------------SSSS------------------------------------------------
E---------x-----------------------------------------------------------------------------------------
>----------x--SSS------------E--------------X-E--E-------------------------------------------------E
]-----------x-SSS-------QQQQQQQQQ-----------XS?SSSSS---X------------------------------------------SS
]------------xSSS-----------------------xxx---------EE-X----------------------------------?QQQ------
]--------------SSx---------------------xxX-xSSSSSSSSSSSX-----------------xxx------------------------
>------------X-SS-xxxxxxxxxxxxxxxxxxxxxx-X--xxxxxxxxxxxxxxxxxxxxxxxxxxxxxxE-xxxxxxxxxxxxxxxxxxxxxxxx
XXXXXX-------XXXXXXXXXXXXXXXXXXXXXXXXXXXXXXXXXXXXXXXXXXXXXXXXXXXXXXXXXXXXXXXXXXXXXXXXXXXXXXXXXXXXXXX