----------------------------------------------------------------------------------------------------
----------------------------------------------------------------------------------------------------
x---------------------------------------------------------------------------------------------------
----------------------------------------------------------------------------------------------------
----------------------------------------------------------------------------------------------------
-------------------------------------------?SS----------------------------------------------------SS
----------------------------------------------------------------------------------------------------
-------------------------------B------------------------------------------------B-------------------
-------------------------------b------------------------------------------------b------------------E
------QQQQ-------------------SSXSS---------------------QQQQ-------------------SSXSS-------xxxxx---SS
-------------B-----E---B----------------E---B-----------------B-----E---B----------------xx-<>-x----
------E------b---------b-----------B--------b-------B--E------b---------b-----------B---xx--[]--x---
xxxxxxxxxxxxxxxxxxxxxxxxxxxxxxxxxxxxxxxxxxxxxxxxxxxxxxxxxxxxxxxxxxxxxxxxxxxxxxxxxxxxxxxxx---[]---xxx
XXxXXXXXXXXXXXXXXXXXXXXXXXXXXXXXXXXXXXXXXXXXXXXXXXXXXXXXXXXXXXXXXXXXXXXXXXXXXXXXXXXXXXXXX--XXXXXXXXX