----------------------------------------------------------------------------------------------------
----------------------------------------------------------------------------------------------------
S----SSSSSSSSSSSSSSSSSSSSSSSSSSSSSSSSSSSSSSSSSSSSSSSSSS?SSSSSSSSSSSSSSSSSSSSSSSSSSSSSSSSSSSSSSSSSSSS
--------------------SS--SSSSSS--SSSS------SSSS------------------------------SSSSSSSSSSSSSSSSSSSSSSSS
--------------------SS--SSSSSS--SSSS--E---SSSS------------------------------SSSSSSSSSSSSSSSSSSSSSSSS
-------oooo-------SS--------SS---S----SS----------oooooo--------------------SSSSSSSSSSSSSSSSSSSSSSSS
------------------SS--------SS---S----SS------------------------------------------------------------
-----S-SSSS-S-----SS--------SS---S----SS----------SSSSSS---------------------------xxx--------------
-----SoS--SoS-----SS----ooooSS---So??-SS---E------SSSSSS--------------------xxxxxxxx?-xxxxxxxxxxxxxx
-----SSS--SSS-----SSSS--SSSSSS---SSS--SS--SSSS-----------------------------xx-SSSSSS??SSSSSSSSSSSSSS
--------------------SS-------------------EE-------------------------------xx--SSSSS---SSSSSSSSSSSSSS
xx------------------SS-----------------------xxxxx----------------xxx-xxxxx---SSSSS---SSSSSSSSSSSSSS
X-xxxxxxxxxxxxxxxxxxxxxxxxxxxxxxxxxxxxxxxxxxxx----xxxxxxxxxxxxxxxxx--xx--x---------oooSSSSSSSSSSSSSS
XXXXXXXXXXXXXXXXXXXXXXXXXXXXXXXXXXXXXXXXXXXXXX---XXXXXXXXXXXXXXXXXX--XX--X---XXXXXXXXXXXXXXXXXXXXXXX