----------------------------------------------------------------------------------------------------
----------------------------------------------------------------------------------------------------
-----------------------xxxx-----------------E-------------------------------------------------------
----------------------xx---x-------------------------------------xxx--------------------------------
---------------------xx-----x----xxxxx------------------------xxxx--x--------------E---------------x
QS------------------xx-------x--xxXXX-x----------------------xx--X---x-----E-SSSSS-----------------x
------------------xxx---------xxxXXXX--x--------------------xx--------x-E--------------------------x
------------o-----xXX----------xEXXXX---x-------------------x----------x--------------------------xx
-------------E----xXX----------XXXXXX----x---------------xxxx-----------x------------------------xxS
?S--------SSSSS--xxXX---------XXXXXXX-----x-------------xx--?S-----------x----SSS----------------x--
-------E--E-----xxXXX-------EXXXXXXXX------x-----------xx-----------------x---------------------xx--
--------------Exx-XXX-------XXXXXXXXX-------xxx-----o-xx-------------------x-------------------xx---
xxxxxxxxxxxxxxxx--XXX------XXXXXXXXXX-------XX-xxxxxxxx---------------------xxxxxxxxxxxxxxxxxxxx----
XXXXXXXXXXXXXXXXXXXXX---XXXXXXXXXXXXXXXXXXXXXXXXXXXXXXX---XXXXXXXXX---------XXXXXXXXXXXXXXXXXXXXXXXX