----------------------------------------------------------------------------------------------------
----------------------------------------------------------------------------------------------------
----------------------------------------------------------------------------------------------------
-------------xxx------------------------------------------------------------------------------------
---xxxx----xxx--x-------------------------------------------------------------E---------------------
--xx---x--xxXS---x--------------------------------------------------------SSSSSSSSSS----------------
-xx-----xxxEX-----x---------------------------------------------------------------------------------
xx-------xXXX------x--------------------------------------------------------------------------------
x--------XXXXS------x------------------B------------------------------------------------------------
>-------XXXXX--------x---------B-------b------------------------------------xxx---SSSSSS?S----------
]------XXXXXX---------x--------b--?-B------?QQ-----------------------------xxX-x--------------------
]-----XXXXXXX----------x-------B----b---------------------xxx------xxxxx--xx-X--x-------------------
]----XXXXXXXX---------X-xxxxxxxxxxxxxxxxxxxxxxxxxxxxxxxxxxx--xxxxxxx----xxx--X---xxxxxxxxxxxxxxxxxxx
X-XXXXXXXXXXXXXXXXXXX-XXXXXXXXXXXXXXXXXXXXXXXXXXXXXXXXXXXXX--XXXXXXX--X-XXXXXXXXXXXXXXXXXXXXXXXXXXXX