----------------------------------------------------------------------------------------------------
----------------------------------------------------------------------------------------------------
--xx------------------------------------------------------------------------------------------------
-xx-x------xxx----xxx-------------------------------------------------------------------------------
xx---x-xxxxx--xxxxx--x-------------------------------------------------------------------xxxxx------
x-----xx--XX--XXXXX---x------------------XXXX-------------------------------------------xxXX--x-----
S-----XX---------------x---------------------------------------------------------------xxXXX---x----
S-----------------------x-------------------------------------------------------------xxXXXX----x---
-------------------------x-----------------------------------------------------------xxXXXXX-----x--
--------------------------x------------------------------------xxx------------------xxXXXXXX---S--x-
---------------------------x-----xxx--------------------------xxX-x----------------xxXXXXXXX-------x
----------------------------x---xxB-x------------xxx-xxx-----xx-X--x--------------xxXXXXXXXX--------
o----------------------------xxxx-b--xxxxxxxxxxxxx--xx--xxxxxx--X---xxxxxxxxxxxxxxxXXXXXXXXX--------
X-------------XXXX--XXXXXX---XXXXXXXXXXXXXXXXXXXXX--XX--XXXXXXXXX--XXXXXXXXXXXXXXXXXXXXXXXXXXXXXXXXX