----------------------------------------------------------------------------------------------------
xxxxxxxxxxxxxxxxxxxxxxxxxxxxxxxxxxxxxxxx------------------------------------------------------------
SSSSSSSSSSSSSSSSSSSSSSSSSSSSSSSSSSSSSSS-x------------SSSSSSSSSSSSSSSSSSSSSSSSSSSSSSSSSSSSSSSSSSSSSSS
-----------------------------------------x-------------[]----[]-------------------------------------
------------------------------------------x------------[]----[]-------E----------------xxx----------
----E--------------------------------------x-----------[]----[]---QQQQQQ--------xxxxxxxx--x---------
---<>---------------------------------------x----------<>----[]----------------xxSSSSSSS---xxxxx----
---[]----------------------------------------x---------------[]---------------xx-SSSSSSS--SSSSS-x---
---[]--------S--------------------E-----------x--------------[]--xxxxxxxxxxxxxx--SSSSSSS--SSSSS--xxx
ESS[]SS----E----E----------------<>-------XXX--x-------------[]-xxSSSSSSSSSSSSS--SSSSSSS--SSSSS?SS?S
---[]-----<>---<>-------------XX-[]---XXX-------x------------<>xx-SSSSSSSSSSSSS-------------------SS
X--[]-----[]---[]------------XXX-[]---XXX--------x----xxx-----xx--SSSSSSSSSSSSS---------<>--------SS
X--[]-----[]---[]--------E-E-XXX-[]---XXX-------X-xxxxx--xxxxxx---SSSSSSSSSSSSS---------[]----------
XXXXXXXXXXXXXXXXXXXXXXXXXXXXXXX--XX---XX------XXXXXXXXX--XXXXXXE--XXXXXXXXXXXXXXXXXXXXXXXXXXXXXXXXXX