----------------------------------------------------------------------------------------------------
----------------------------------------------------------------------------------------------------
--------------------------------------------------------------------------E-------------------------
----------------------------------------------------------------------------------------------------
----------------------------------------------------------------------------------------------------
---------------------------------------------------------------------------XX-----------------------
----------------------------------------------------------------------------------------------------
----------------------------------------------------------------------------------------------------
---------------------------------------------------E---------------X----X---------------------------
?QQQQQQQ?-------------------------------------QQQQQQQ-----------X-------------------------------xxx-
--------------------------------XXXXXXXXXXXXXX------------------X------------------------------xxX-x
B-----------------?-------------------------------------<>------X--------------------x------B-xx-X--
b-E-----B-----E------------E----------------------------[]------X---------X-----------xxxxxxxxx--X--
XXXXXX-XXXXXXXXXXX-XXXXXXXXXXXXXXXXXXXXXXXXXXXXX-XXXX---XXXXXXXXX----XXXXXX----------XXXXXXXXXX--XXX