----------------------------------------------------------------------------------------------------
---------------------------------------------------------------------------------------xxxx---------
XX------------------------------------------------------------------------------------xx---x--------
]------------------------------------------------------------------------------------xx-----x-------
]----------------------------------------------------------------------ooo-----xxxxxxx-------x------
]----------------------------------------------------------------------XXXX---xx---XXX--------x-----
]----------------------------------------------------------------------------xx----------------x-E--
]-------------------------------xx------------------------------------------xx------------------x---
>------xxxx--------------------xx-x----------------X-Xxxx------------------xx--------------------x--
------xxX--x------------------xx---xxxxxxxxxxxxxxxxxxxx--xxxxxxxxxxxxxxxxxxx--------------XX------x-
-----xx-X---x----------------xx----XXXXXXXXXXXXXXXXXXXXEXXXXXXXXXXXXXXXXXXXXE-XX-------------------x
----xx--X----x--------------xx-----XXX-----------------------X--------------------------------------
xxxxx--EX-----xxxxxxxxxxxxxxxX-----XXX-----------------------X--------------------------------------
XXXXXXXXX-----XXEXXXXXXXXXXXXX-----XXX-----------------------X--------------------------------------