----------------------------------------------------------------------------------------------------
----------------------------------------------------------------------------------------------------
SSSSSSSSSSSSSSSSSSSSSSSSSSSSSSSSSS?SSSSSSSSSSSSSSSSSSSSSSSSSSSSSSSSSSSSSSSSSSSSSSS------------------
S--SSSSSS--SSSS------SSSS---------------------------------------------------------------------------
S--SSSSSS--SSSS--E---SSSS-----------------------------------------------------------XXX-------------
-------SS---S----SS----------oooooo---------------------------------------------------------------XX
-------SS---S----SS-------------------------------xx------------------------------------------------
-------SS---S----SS----------SSSSSS--------------xx-x-xxx-------------------------------------------
---ooooSS---So??-SS---E------SSSSSS-------------xx---xx--x---------------------xxxxx----SSSSS??-----
S--SSSSSS---SSS--SS--SSSS---------------------xxx----<>---x------xxxx---------xxXXX-xxx-------------
S-------------------EE-----------------------xx<>----[]----xxx--xxSS-x-------xxEXXX-XXXx------------
S-----------------------xxxxx---------------xx-[]----[]----<>-xxx-SS--x-----xxXXXXX-----x------xxx--
xxxxxxxxxxxxxxxxxxxxxxxxx----xxxxxxxxxxxxxxxx--[]----[]--E-[]--x--SS---xxxxxxXXXXXX------xxxxxxx--xx
XXXXXXXXXXXXXXXXXSXXXXXXX---XXXXXXXXXXXXXXXXXXXXXXXXXXXXXXXXXXXX--XX--XXXXXXXXXXXX------XXXXXXXX--XX