----------------------------------------------------------------------------------------------xxx---
---------------------------------------------------------------------------------------------xx--x--
--------------------------------------------------------------------------------------------xx----x-
-------------------------------------------------------------------------------------------xx------x
-----------------------------------------------------------------------------------------xxx--------
----------------E-----------------------------------------------------------------------xxXX--------
---------------SSSS--------------------------------------------------------------------xxXXX--------
--------------------------------------------------------------------------------------xxXXXX--------
-----------X-E--E--------------------------------------------------------------------xxXXXXX--------
-----------XS?SSSSS---X-------------------------------------------------------------xxXXXXXXS-------
-------xxx---------EE-X--------------------------------E---------------------------xxXXXXXXX--------
xxx---xxX-xSSSSSSSSSSSX-----------------xxx---------------------xxxxxx------------xxXXXXXXXX--------
x--xxxx-X--xxxxxxxxxxxxxxxxxxxxxxxxxxxxxxE-xxxxxxxxxxxxxxxxxxxxxxE-EE-xxxxxxxxxxxxxXXXXXXXXX--------
X--XXXXXXXXXXXXXXXXXXXXXXXXXXXXXXXXXXXXXXXXXXXXXXXXXXXXXXXXXXXXXXXXXXXXXXXXXXXXXXXXXXXXXXXXXXX------