----------------------------------------------------------------------------------------------------
----------------------------------------------------------------------------------------------------
----------------------------------------------------------------------------------------------------
----------------------------------------------------------------------------------------------------
----------------------------------------------------------------------------------------------------
--------------------------------------------------------------xxxx----------------------------------
--X--EX-------------------------------------------------------x<>-x-------------------------ES------
--X---X-------------------------------------------------------x[]--x-----------------S------------QQ
X-X---X--------X-EE----X-------------ooo----------------E----xx[]---x----xxxx-----------------------
X-XSS?X--------XSSSSSSSX-------------ooo--------------------xxS[]----x--xx---xx---------------------
----------------------------------------------------oo-----xx--[]-----xxx----X-x------xxx-----------
-----------xxx--------------------------------------oo----xx---[]------x-----XX-xx---xxB-x----------
xxxxxxxxxxxx--xxxxxxxxxxxxxxxxxxxxxxxxxxxxxxxxxxxxxxxxxxxxx----[]------B-----XXXX-xxxx-b--xxxxxxxxxx
XXXXXXXXXXXX--XXXXXXXXXXXXEEXEXXXXXXXXXXXXEEXEXXXXXXXXXXXXXXXXXXXXXXXXXX-----XXXXXXXXXXXXXXXXXXXXXXX