----------------------------------------------------------------------------------------------------
----------------------------------------------------------------------------------------------------
SSSSSSSSSSSSSSSSSSSS--------------------------------------------------------------------------------
S---------------------------------------------------------------------------------------------------
S---------------------XXX------------------------------------------------------xxxxxxxxxxx----------
-------------------------------------XXX----------------------SSSSS---?-------xx--QQQ?QQQ-x-------SS
-----------------------------------------------------------------------------xx------------x--------
----------------------------------------------------------------------------xx------E-------x-------
-----------------xxxxx-----SSSSS??----------------------------------------xxx-----SSSSSSS----x------
S--xxxx---------xxXXX-xxxx-------------------------xxx-----S---E---------xx<>--------------E--x-----
--xxSS-x-------xxEXXX-XXX-x-----------------------xxX-x-------------E---xx-[]-------X------X---x---E
Exx-SS--x-----xxXXXXX------x------xxx-----------Exx-X--x---------------xx--[]-------X------X----x---
xx--SS---xxxxxxXXXXXX-------xxxxxxx--xxxxxxxxxxxxx--X---xxxxxxxxxxxxxxxx---[]----E--X------X-----xxx
XX--XX---XXXXXXXXXXX-------XXXXXXXX--XXXXXXXXXXXXX--XXXXXXXXXXXXXXXXXXXXXXXXXXXXXXXXXXXXXXXXXXXXXXXX