----------------------------------------------------------------------------------------------------
----------------------------------------------------------------------------------------------------
-------xx---------------------------------------------------------S---------------------------------
------xx-x------------------------------------------------------------------------------------------
-----xx---x------------------------------SSS----SSSS---------------------E--------------------------
S---xx-----x-----S---------XQQ?QQX---------------------------SSSSSS----QQQQQQQ----------------E-----
-xxxx-------x----S---------X-----X-----------------------------------------------------------SSSS---
xxXXX--------x-------------X-----X-------X----------------------------------------------------------
x-------------x--SSS-------XE-E--X-------XEE-------X----------------------E--------------X-E--E-----
S----S---------x-SSS-------XQQ-QQX-------XSSSSSSSSSX--------xxxx------QQQQQQQQ-----------XS?SSSSS---
S----SS---------xSSS---------------------------------------xx---x--------------------xxx---------EE-
x----SS-----------SSx------------E-----------------xxxxx--xx-----x------------------xxX-xSSSSSSSSSSS
-----SS---------X-SS-xxxxxxxxxxxxxxxxxxxxxxxxxxxxxxx----xxx-------xxxxxxxxxxxxxxxxxxx-X--xxxxxxxxxxx
XXXXXSSSX-------XXXXXXXXXXXXXXXXXXXXXXXXXXXXXXXXXXXX----XXX------XXXXXXXXXXXXXXXXXXXXXXXXXXXXXXXXXXX