----------------------------------------------------------------------------------------------------
----------------------------------------------------------------------------------------------------
----------------------------------------------------------------------------------------------------
----------------------------------------------------------------------------------------------------
----------------------------------------------------------------------------------------------------
-------SSS------------------------------------------------------------------------------------------
----------------------------------------------------------------------------------------------------
----------------------------------------------------------------------------------------------------
-----xxxxxxx-------------------------------------------------xxxxxx----X----------------------------
-E--xxXXXXX-x-------------------xxx-------------------------xxXSSS-x---X----------------------------
-E-xx-X------x-----------------xxX-x-----------------------xx-X-----x-------------------------------
--xx--X-------x-------------B-xx-X--x---------------------xx--X------x--------Exxx-----------xxxx---
xxx---X--------xxxxxxxxxxxxxxxx--X---xxxxxxxxxxxxxxxxxxxxxxE-EX-------xxxxxxxxxx--xxxxxxxxxxxxEE-xxx
XXXXXXXXX----XXXXXXXXXXXXXXXXXX--XXXXXXXXXXXXXXXXXXXXXXXXXXXXXXXXXX---XXXXXXXXXX--XXXXXXXXXXXXXXXXXX