----------------------------------------------------------------------------------------------------
-------------------------------------------------------------------------xxxxxxxxxxxxxxxxxxxxxxxxxxx
---------------SSSSSSSSSSSSSSSSSSSSSSSSSSSSSSSSSSSSSSSSSSSSSSSSS--------xxSSSSSSSSSSSSSSSSSSSSSSSSSS
----------------------------SSSSSSSSSSSSSSSSSSSSSSSSSSS----------------xx---------------------------
----------------------------SSSSSSSSSSSSSSSSSSSSSSSSSSS-----------XXX-xx----------------------------
----------------------------SSSSSSSSSSSSSSSSSSSSSSSSSSS--QQ------xxxx-xSSS------------E-------------
-----------------------------------------------------E----------xx---xx--------------<>-------------
-----------------------------------xxx----------------xxx-xxx--xx-----xS-------------[]-------------
----------------------------xxxxxxxx?-xxxxxxxxxxxxxxxxx--xx--xxx------S-S------------[]-------S-----
---------------------------xx-SSSSSS??SSSSSSSSSSSSSSSSS--QQ--QQQ---------S------E--SS[]S----E----E--
--------xxx---------------xx--SSSSS---SSSSSSSSSSSSSSSSS------------------------<>----[]----<>---<>--
-------xxB-x-----xxx-xxxxxx---SSSSS---SSSSSSSSSSSSSSSSS------------------------[]----[]----[]---[]--
xxxxxxxx-b--xxxxxx--xx---x---------oooSSSSSSSSSSSSSSSSS------------------------[]-E--[]----[]---[]--
XXXXXXXXXXXXXXXXXX--XX---X---XXXXXXXXXXXXXXXXXXXXXXXXXXXXXXXXXXX------XXXXXXXXXXXXXXXXXXXXXXXXXXXXXX