----------------------------------------------------------------------------------------------------
----------------------------------------------------------------------------------------------------
--------?-------------------------------------------------------------------------------------------
----------------------------------------------------------------------------------------------------
----------------------------------------------------------------------------------------------------
-------S----------------------------------SSSSSSSS--------------------------------------------------
-----------------------------------------------------------------------------xxx--------------------
x---------------------------------------------------------------------------xxX-x-------------------
-xxxxxxxxxx--------------------xxx----------xxxxxxx------------------------xxXX--xo------o----o-----
-XXXXXXXXX-x----xxxx----------xx--x-------xxxSSSSS-x----QQQQ--------------xxXXX---x-----------------
XX----------x--xx---xxxxx----xx----x-----xx<>-------x--------------------xxXXXX----x----------------
XX-----------xxx----XXXX-x--xx------xxx-xx-[]--------x----E-------------xxXXXXX-----x--xxxxxxxxxx--x
XX------------x-----------xxx-------XX-xx--[]---------xxxxxxxxxxxxxxxxxxxXXXXXX------xxx----x----xxx
X-----------XXX-----------XXX-------XXXXXXXXXXXXXXXXXXXXXXXXXXXXXXXXXXXXXXXXXXXXXXXXXXXX---XX---XXXX