----------------------------------------------------------------------------------------------------
------------------------xxxx------------------------------------------------------------------------
-----------------------xx---xx----------------------------------------------------------------------
----------------------xx---<>-x-----------------------------------------------------------XXXXXXXXXX
----------------------xx---[]--x---------------------------------------------------------XX---------
----------------------Sx---XX---x-------------------------------------------------------XXX---------
--------------------xxxx---------x-----------------------------------------------------XXXX---------
-------------------xx--x----------x--------------------------------------E------------XXXXX---------
o---xxx-----------xx---S-----------x-------oo-----------------------------XXX------X--XXXXX---------
---xx<-x---------xx-----------------x---------xxx------------------------------------XXXXXX---------
--xx-[]-x------xxx-------------------x-------xxX-x---xxxx---------------------------XXXXXXX----<>---
-xx--[]--x----xx<>-----------------X--x-----xx-X--x-xx<>-x-------------------------XXXXXXXX----[]---
xx---[]---xxxxx-[]---E-------------X---xxxxxx--X---xx-[]--xxxxxxxxxxxxxxx---------XXXXXXXXX----[]---
XXX--XXXXXXXXXXXXXXXXXXXX----------XXXXXXXXXXXXXXXXXXXXX--XXXXXXXXXXXXXXX--------XXXXXXXXXXXXXXXXXXX