----------------------------------------------------------------------------------------------------
----------------------------------------------------------------------------------------------------
----------------------------------------------------------------------------------------------------
----------------------------------------------------------------------------------------------------
----------------------------------------------------------------------------------------------------
-----------------------------------------------QQQQ-------------------------------------------------
--oooo------------oooo------------oooo--------------------------------------------------------------
----------------------------------------------------------------------------------------------------
xx------------xxxx------------xxxx------------------------------------------------------------------
>-x----------xx<>-x----------xx<>-x----------QQ?SSQQQ----------------------------------xxx----------
]--x--------xx-[]--x--------xx-[]--x-------------------------xxxx---------------------xxX-x---------
]---x------xx--[]---x------xx--[]---x----------xxx----------xx<>-x------xxxxx-xxx----xx-X--x--------
x----xxxxxxx---[]----xxxxxxx---[]----xxxxxxxxxxx--xxxxxxxxxxx-[]--xxxxxxx----xx--xxxxx--X---xxxxxxxx
XXXXXXXXXXXXXXXXXXXXXXXXXXXXXXXXXXXXXXXXXXXXXXXX--XXXXXXXXXXXXXXXXXXXXXXX---XXX--XXXXXXXX--XXXXXXXXX