----------xxx----xxx--------------------------------------------------------------------------------
----------x--x--xx--x-------------------------------------------------------------------------------
SS--[]SSSSS---xxx----x------------------------------------------------------------------------------
----[]SSSSS----x------x-------------xxx-------------------------------------------------------------
----[]SSSSS------------x---------xxxx--x------------------------------------------------------------
----[]SSSSS----E--------x-------xx--X---x-----S-----------SS----------------------------------SSSSS-
----[]SSSSS---<>---------x-----xx--------x----S----------------------E------------------------------
----[]SSSSS---[]----------xxxxxxE---------x-------------B-----------<>------------------------------
-----]SSSSS---[]-----------x---<>----------x--SSS-------bX----------[]-------------------------E----
xxxx-]SSSSS---[]-----------?---[]-----------x-SSS-------XX----------XX------------------------SSSSS-
QQSSSSSSSSS---[]---------------[]------------xSSS-------------------------xxxx---------xxxx--------x
SSSSSSSSSSS---[]---------------[]--------------SSx--------------xxx----B-xx<>-x---B---xx<>-x------xx
SSSSSSSSSSS---[]-----E---------[]------------X-SS-xxxxxxxxxxxxxxx--xxxxxxx-[]--xxxxxxxx-[]--xxxxxxx-
XXXXXXXXXXXXXXXXXXXX<>XXXXXX---XXXXXXX-------XXXXXXXXXXXXXXXXXXXX--XXXXXXXXXXXXXXXXXXXXXXXXXXXXXXXXX