--------------------------------------xxx-----------------------------------------------------------
-------------------------------------xx--x----------------------------------------------------------
------------------------------------xx----x---------------------------------------------------------
------------------------------xxxxxxx------x-------------xxx----------------------------------------
-----------------------------xx----x--------x---------xxxx--x---------------------------------------
------SSSSS-----SSSSS--------xX----E---------x-------xx--X---x-----S---------XQQ?QQX----------------
-----S-----------[]---------xx----<>----------x-----xx--------x----S---------X-----X----------------
----SS-----------[]---------x-----[]-----------xxxxxxE---------x-------------X-----X----------------
---SSS-------?---[]-------xxx-----[]------------x---<>----------x--SSS-------XE-E--X---------------x
--SSSS-----------<>------xx<>-----[]------------?---[]-----------x-SSS-------XQQ-QQX--------------xx
------------------------xx-[]-----[]----------------[]------------xSSS---------------------------xx-
-xxx----------xxx-E----xx--[]-----[]----------------[]--------------SSx------------E-------xxxxxxx--
xxB-xxxxxxxxxxxB-xxxxxxx---[]-----[]------E---------[]------------X-SS-xxxxxxxxxxxxxxxxxxxxx--XXXX--
XXXXXXXXXXXXXXXX-XXXXXXXEXXXX-----XXXXXXX<>XXXXXX---XXXXXXX-------XXXXXXXXXXXXXXXXXXXXXXXXXX--------