----------------------------------------------------------------------------------------------------
------xxx-------------------------------------------------------------------------------------------
-----xx--x----SSSSSSSSSSSSSSSS-------------SSS-[]SSSSSSSSSSSSSSSSS-------------------------------S--
----xx----xx--SSSS-----------------------------[]SSSSSSSSSSSSSSSSS------------------XXXXXXXXXXX--S--
xxxxx-----E-x-SSSS-----------------------------[]SSSSSSSSSSSSSSSSS-----------------XX------------S--
SSSSS--------xSSSS-------------xx--xxxxx-------[]SSSSSSSSSSSSSSSSS----------------XXX------------S--
--------------x---------------xx-xxx----x------[]SSSSSSSSSSSSSSSSS---------------XXXX------------S--
---------------x-------------xx--XXX-----x-----[]SSSSSSSSSSSSSSSSS--------------XXXXX------------S--
---------------oxxx------xxxxx------------x-----]SSSSSSSSSSSSSSSSS-------------XXXXXX------------S--
--------------S?SS-x----xx-XXX-------------xxxx-]SSSSSSSSSSSSSSSSS-------E----XXXXXXX------------S--
--------------SSS---x--xx-----------SSS-S--SSSSSSSSSSSSSSSSSSSSSSS------<>---XXXXXXXX----<>------S--
<>------------SS-----xxx------------SSS-S--SSSSSSSSSSSSSSSSSSSSSSS--<>--[]--XXXXXXXXX----[]------S--
b]--------------E-EE--xX------------SSS-S--SSSSSSSSSSSSSSSSSSSSSSS--[]--[]-XXXXXXXXXX----[]------Sxx
XXXXXXXXXXXXXXXX-XXXXXXX---------XXXSSS-S--XXXXXXXXXXXXXXXXXXXXXXX--XX--XXXXXXXXXXXXXXXXXXXXXXXXXXxX