----------------------------------------------------------------------------------------------------
------------------------------------------------------------xxx-------------------------------------
-------------------------------E---------------------------xx--x------------------------------------
----------------------------------------------------------xx----xx----------------------------------
---------------------------------------------------------xx-----E-xxxxxx----------------------------
B----------------------SSSSSSSS?S--------S----S--------xxx---------x----x--------SSSSSSSSSS---------
[--------E--------------[]----------------------------xx-S--------<>-----x-----------------------E--
QQ------<>--------------[]---------------------------xx-----------[]------xxxxx-----------------<>--
--------[]--------------[]--------------xxxx--------xx------------[]-------xB-Xxxxxxxxxxxxxx----[]--
-----QQQQQQQQQQ---------[]-------------xx<>-x------xx-------X-----XX-------XXXXXESSSSSSSSSS-x---XX--
------------------------<>------------xx-[]--x----xxE---------------------XXXXXXX------------x------
-xxxxx------------------xxx----------xx--[]---x--xx<>--------------------XXXXXXXX-------------x----B
xxB---xxxxxxxxxxxxxxxxxxxE-xxxxxxxxxxx---[]----xxx-[]-----X-------------XXXXXXXXX-----E--------xxxxx
XXX--XXXXXEEXXXXXXXXXXXXXXXXXXXXXXXXXXXXXXXXXXXXXXXXXXXXXXX-------------XXXXXXXXXXXXXXXXXXXX---XXXXX