----------------------------------------------------------------------------------------------------
----------------------------------------------------------------------------------------------------
---------------------------------------------------------------------------------------------------x
--------------------------------------------------------------------------------------------------xx
-------------------------------------------------------------------------------------------------xx-
-------E--S---SSSSSSSSS------------SS---------------------SSSSSSSS?S-------------S----S--------xxx--
------<>------------------------------------E--------------[]---------------------------------xx-S--
------[]-----------------------------------<>--------------[]--------------------------------xx-----
------[]------------xxxx---------SS--------[]--------------[]-------------------xxxx--------xx------
-----SXXS----------xx--xxx-xxx----------QQQQQQQQQQ---------[]------------------xx<>-x------xx-------
xxx------xxxx-----xx------xx--xxx--------------------------<>-----------------xx-[]--x----xxE-------
<>-x----xx<>-x---xx-------<>--<>-x-xxxxxx------------------xxx----xxxxxxx----xx--[]---x--xx<>-------
[]--xxxxx-[]--xxxx--------[]--[]--xx-----xxxxxxxxxxxxxxxxxxxE-xxxxx---x--xxxxx---[]----xxx-[]-----X-
XXXXXXXXXXXXXXXXXX------XXXXXXXXXXXX-X--XXXXXEEXXXXXXXXXXXXXXXXXXXX-X-X--XXXXXXXXXXXXXXXXXXXXXXXXXX-