----------------------------------------------------------------------------------------------------
----------------------------------------------------------------------------xx----------------------
]SSSSSSSSSSSSSSS----------------------------------S------------------------xx-x---------------------
]SSSSSSSSSSSSSSS-------------------XXXXXXXXXXXXX--S-----------------------xx---x----xxx-------------
]SSSSSSSSSSSSSSS------------------XX--------------S-----------------xxxxxxx-----xxxxx--x------------
]SSSSSSSSSSSSSSS-----------------XXX--------------S--------------xxxx---XXX-----XXXXXE--x-----------
]SSSSSSSSSSSSSSS----------------XXXX--------------S-------------xxXXX--------------------x----------
]SSSSSSSSSSSSSSS---------------XXXXX--------------S------------xx-------------------------x---------
]SSSSSSSSSSSSSSS--------------XXXXXX--------------S--------xxxxx---------------------------x--------
]SSSSSSSSSSSSSSS--------E----XXXXXXX--------------S-------xx-XXX--------XXX-----------------x-------
SSSSSSSSSSSSSSSS-------<>---XXXXXXXX------<>------S------xx----------------------------------xxxxxx-
SSSSSSSSSSSSSSSS--<>---[]--XXXXXXXXX------[]------S-----xx------------------------------------x----x
SSSSSSSSSSSSSSSS--[]---[]-XXXXXXXXXX------[]------Sxxxxxx-----------------------------XXXXEXXEX----X
XXXXXXXXXXXXXXXX--XX---XXXXXXXXXXXXXXXXXXXXXXXXXXXXxXXXXX-------------------------------------------