----------------------------------------------------------------------------------------------------
--------------------xxxxxxxxxxxxxxxxxxxxxxxxxxxxxxxxxxxxxxxxxxxxxxxx--------------xxxxxxxxxxxxxxxxxx
SSSSSSSSSSS--------xxSSSSSSSSSSSSSSSSSSSSSSSSSSSSSSSSSSSSSSSSSSSSSS-x-----SSSS---xxSSSSSSSSSSSSSSSSS
SS----------------xx-------------------------------------------------x----------xx------------------
SS-----------XXX-xx---------------------------------------------------x----?---xx-------------------
SS--QQ------xxxx-xSSS------------E-------------------------------------x--S??-xx--------------------
-----------xx---xx--------------<>--------------------------------------x----xxXXX------------------
-xxx-xxx--xx-----xS-------------[]---------------------------------------x--xx----------------------
xx--xx--xxx------S-S------------[]-------S---------------------E----------xxx---------------------E-
SS--QQ--QQQ---------S------E--SS[]SS---E----E-----------------<>------XXX-SSSS----------------E--<>-
S-------------------------<>----[]----<>---<>--------------XX-[]--XXX------------------E-----<>--[]-
S-------------------------[]----[]----[]---[]-------------XXX-[]--XXX-----------------<>-----[]--[]-
So?-----------------------[]-E--[]----[]---[]---------E-E-XXX-[]--XXX-----------------[]---E-[]--[]-
XXXXXXXXXXX------XXXXXXXXXXXXXXXXXXXXXXXXXXXXXXXXXXXXXXXXXXX--XX--XX------XXXX------XXXXXXXXXXXXXXX-