----------------------------------------------------------------------------------------------------
----------------------------------------------------------------------------------------------------
--------SSSSSSSSSSSSSSSSSSSSSSSSSSSSSSSSSSSSSSSSSSSSSSSSSSSSSSSSSSSSSSSSSSSSSSSSSSSSSSSSSSSSSSSSSSSS
----------------------SSSSSSSSSSSSSSSSSSSSSSSSSSSS-----------------------SSSSSSSSSSSSSSSSSSSSSSSSSSS
----------------------SSSSSSSSSSSSSSSSSSSSSSSSSSSS-----------------------SSSSSSSSSSSSSSSSSSSSSSSSSSS
----------------------SSSSSSSSSSSSSSSSSSSSSSSSSSSSx----------------------SSSSSSSSSSSSSSSSSSSSSSSSSSS
----------------------------------------------------xxxxx-------------------------------------------
-----------------------------xxx-----------------xxxSSSS-x---------------------------xxxxx--------xx
----------------------xxxxxxxx?-xxxxxxxxxxxxxxxxxx--SSSS--xxxxxxxxxxxxxxxxxxxxxxxxxxxx----xxxxxxxxxE
x--------------------xx-SSSSSS??SSSSSSSSSSSSSSSSSS--SSSS?SS?SSSSS????????SSSSSSSSSSSS?----SSSSSSSSSS
-x------------------xx--SSSSS---SSSSSSSSSSSSSSSSSS---------SSSSSSSSSSSSSS---------------------------
--xx--------xxx-xxxxx---SSSSS---SSSSSSSSSSSSSSSSSS---------SSSSSSSSSSSSSS--------------<>-----------
o-X-xxxxxxxxx--xx--x---------oooSSSSSSSSSSSSSSSSSS-------------------------------------[]-----------
XXXXXXXXXXXXX--XX--X---XXXXXXXXXXXXXXXXXXXXXXXXXXXXXXXXXXXXXX-XX-XXXXXXXXXXXXXXXXXXXXXXXXXXXXXXXXXXX