----------------------------------------------------------------------------------------------------
-----------------------------------------------------------------------xxx--------------------------
--------------SS--------------------E---------------------------------xx--x-------------------------
--------------[]-------------------<>--------------------------------xx----xx-----------------------
--------------[]-------------------[]-------------------------------xx-----E-xxxxxx-----------------
SS-----------S<>-------------------[]---------SSSSS-----SSSSS-------xX--------x----x-------SSSSSSS--
----------------------E----------------------S-----------[]--------xx--------<>-----x---------------
x--------------E-----<>---------------------SS-----------[]--------x---------[]------xxxx--------xxx
-x----------xxxx-----[]--------------------SSS-------?---[]------xxx---------[]-------xB-xxxxxxxxx--
--x--------xx<>-x-QQQQQQQQQQ--------------SSSS-----------<>-----xx<>---------XX-------XXXXESSSSSSS--
---x------xx-[]--x---------------------------------------------xx-[]-----------------XXXXXX---------
oo--x----xx--[]---x-----------------xx---xxx----------xxx-E---xx--[]----------------XXXXXXX---------
oo---xxxxx---[]----xxxxxxxxxxxxxxxxxx-xxxxB-xxxxxxxxxxxB-xxxxxx---[]---------------XXXXXXXX---------
XX-XXXXXXXXXXXXXXXXXXXXEEXXXXXXXXXXXXXXXXXXXXXXXXXXXXXXX-XXXXXXEXXXX---------------XXXXXXXXXXXXXXXXE