----------------------------------------------------------------------------------------------------
xxxxxxxxxxxxxx--------------xxxxxxxxxxxxxxxxxxxxxxxxxxxx--------------------------------------------
SSSSSSSSSSSSS-x-----SSSS---xxSSSSSSSSSSSSSSSSSSSSSSSSSS-x---SSSSSSSSSSSSSSSS-------------SSS---[]SSS
---------------x----------xx-----------------------------x--SSSS-------------------------------[]SSS
----------------x----?---xx-------------------------------x-SSSS-------------------------------[]SSS
-----------------x--S??-xx---------------------------------xSSSS-------------xx--xxxxx---------[]SSS
------------------x----xxXXX--------------------------------x---------------xx-xxx----x--------[]SSS
-------------------x--xx-------------------------------------x-------------xx--XXX-----x-------[]SSS
---------E----------xxx---------------------E----------------oxxx------xxxxx------------x-------]SSS
--------<>------XXX-SSSS----------------E--<>---------------S?SS-x----xx-XXX-------------xxxxxx-]SSS
-----XX-[]--XXX------------------E-----<>--[]---------E-----SSS---x--xx-----------SSS-S--SSSSSSSSSSS
----XXX-[]--XXX-----------------<>-----[]--[]--------<>-----SS-----xxx------------SSS-S--SSSSSSSSSSS
E-E-XXX-[]--XXX-----------------[]---E-[]--[]--------[]-------E-EE--xX------------SSS-S--SSSSSSSSSSS
XXXXXX--XX--XX------XXXX------XXXXXXXXXXXXXXX--XXXXXXXXXXXXXXX-XXXXXXX---------XXXSSS-S--XXXXXXXXXXX