----------------------------------------------------------------------------------------------------
----------------------------------------------------------------------------------------------------
----------------------------------------------------------------------------------------------------
----------------------------------------------------------------------------------------------------
-------xxx------------------------------------------------------------------------------------------
------xx--x------------------------------------xxx----------------------------------------------E-E-
-----xx----x----------------------------------xxX-x--------------------------------------------<><><
----xx------x--------------------------------xxXX--x--------------xxxxx------------------------[][][
--xxx--o-----xxx----------------------------xxXXX---x----------xxxx-<>-x-------------------Q?--QQQQQ
-xx<>--------<>-x--------------------------xxXXXX----x--------xxQQ?-[]--x---------------------------
xx-[]--------[]--x-----------------<>-----xxXXXXX-----x------xx-----[]---x--------------------------
x--[]--------[]---x----------------------xxXXXXXX------x----xx------[]----x-----------------xxx-----
---[]--------[]-E-ExxxxxxxxxxxxxxxxxxxxxxxXXXXXXX-------xxxxx--X----[]-----xxxxxxxxxxxxxxxxxx--xxxxx
XXXXXXXXXXXXXXXXXXXXXXXXXXXXXXXXXXXXXXXXXXXXXXXXXXXXXXXXXXXXXXXXXXXXXXXXXXXXXXXXXXXXXXXXXXXXX--XXXXX