----------------------------------------------------------------------------------------------------
---------------------------------------------------------------xxxxxxxxxxxxxxxxxxxxxxxxxxxxxxxxxxxxx
SSSSSSSSSSSSSSSSSSSSSSSSSSSSSSSSSSSSSSSSSSSSSSSSSSSSSS--------xxSSSSSSSSSSSSSSSSSSSSSSSSSSSSSSSSSSSS
--SSSS--------------SSSSSSSSSSSSSSSSSSSSSSSSS----------------xx-------------------------------------
--SSSS--------------SSSSSSSSSSSSSSSSSSSSSSSSS-----------XXX-xx--------------------------------------
--SSSS--------------SSSSSSSSSSSSSSSSSSSSSSSSS--QQ------xxxx-xSSS-----------E------------------------
------o-----------------------------------------------xx---xx-------------<>------------------------
xxxxxxx---------------------xxx-------------xxx-xxx--xx-----xS------------[]------------------------
--x--E-x------------xxxxxxxxx?-xxxxxxxxxxxxxx--xx--xxx------S-S-----------[]-------S----------------
--SSSS--xx---------xx-SSSSSSS??SSSSSSSSSSSSSS--QQ--QQQ---------S-----E--SS[]SS---E----E-------------
-------XX-xx------xx--SSSSSS---SSSSSSSSSSSSSS-----------------------<>----[]----<>---<>-------------
-------XXXX-x----xx---SSSSSS---SSSSSSSSSSSSSS-----------------------[]----[]----[]---[]------------X
E------XXXX--xxxxx----------oooSSSSSSSSSSSSSS-----------------------[]-E--[]----[]---[]--------E-E-X
XXXXXXXXXXX-XXXXXX---XXXXXXXXXXXXXXXXXXXXXXXXXXXXXXXXX------XXXXXXXXXXXXXXXXXXXXXXXXXXXXXXXXXXXXXXXX