----------------------------------------------------------------------------------------------------
----------------------------------------------------------------------------------------------------
----------------------------------------------------------------------------------------------------
----------------------------------------------------------------------------------------------------
--------------------------------------------xxxxx-----------------------xxxxxxxxxxx----------E-E----
-E--S---SSSSSSSSS------------------------xxxx--X-x---------------------xx--QQQ?QQQ-x-------SSSSSSS-S
<>--------------------------------------xx--E--X--x-------------------xx------------x-------------E-
[]-------------------------------------xx---XX-X---x-----------------xx------E-------x--------------
[]------------xxxx-------------------xxx----XX-X----x--------------xxx-----SSSSSSS----x-----------xx
XXS----------xx--xxx-xxx------------xx<>----XX-X-----x------------xx<>--------------E--x---------xx<
---xxxx-----xx------xx--xxx--------xx-[]----XX-X------x----------xx-[]-------X------X---x---E---xx-[
--xx<>-x---xx-------<>--<>-x----B-xx--[]----XX-X-------x--------xx--[]-------X------X----x-----xx--[
xxx-[]--xxxx--------[]--[]--xxxxxxx---[]----XX-X-------Xxxxxxxxxx---[]----E--X------X-----xxxxxx---[
XXXXXXXXXXXX------XXXXXXXXX-XXXXXXXXXXXXXXXXXX-XXXXXXXXXXXXXXXXXXXXXXXXXXXXXXXXXXXXXXXXXXXXXXXXXXXXX