----------------------------------------------------------------------------------------------------
--------------------xxxxxxxxxxxxxxxxxxxxxxxxxxxxxxxxxxxxxxxxxxxxxxx--------------xxxxxxxxxxxxxxxxxxx
SSSSSSSSSSS--------xxSSSSSSSSSSSSSSSSSSSSSSSSSSSSSSSSSSSSSSSSSSSSS-x-----SSSS---xxSSSSSSSSSSSSSSSSSS
SS----------------xx------------------------------------------------x----------xx-------------------
SS-----------XXX-xx--------------------------------------------------x----?---xx--------------------
SS--QQ------xxxx-xSSS------------E------------------------------------x--S??-xx---------------------
-----------xx---xx--------------<>-------------------------------------x----xxXXX-------------------
-xxx-xxx--xx-----xS-------------[]--------------------------------------x--xx-----------------------
xx--xx--xxx------S-S------------[]-------S--------------------E----------xxx---------------------E--
SS--QQ--QQQ---------S------E--SS[]SS---E----E----------------<>------XXX-SSSS----------------E--<>--
SS------------------------<>----[]----<>---<>-------------XX-[]--XXX------------------E-----<>--[]--
SS------------------------[]----[]----[]---[]------------XXX-[]--XXX-----------------<>-----[]--[]--
SS------------------------[]-E--[]----[]---[]--------E-E-XXX-[]--XXX-----------------[]---E-[]--[]--
XXXXXXXXXXX------XXXXXXXXXXXXXXXXXXXXXXXXXXXXXXXXXXXXXXXXXX--XX--XX------XXXX------XXXXXXXXXXXXXXX--