----------------------------------------------------------------------------------------------------
----------------------------------------------------------------------------------------------------
----------------------------------------------------------------------------------------------------
-----------------------------------xxx--------------------------------------------------------------
-------------------------xxxx----xxx--x--------------------xxx--------oo----------------------------
E-E------------S--------xx---x--xxXS---x------------------xx--x-----------------------SSS-----------
><>--------------------xx-----xxxEX-----x----------------xx----x------------------------------------
][]-------------------xx-------xXXX------x--------------xx------x-----------------------------------
QQQ--------------xxxxxx--------XXXXS------xxx-----o---xxx--o-----xxx-------------------------------S
------------Q--xxx---<>-------XXXXX-------<>-x-------xx<>--------<>-x-----------------SSS-xxx-------
-------xxxx---xx<>---[]------XXXXXX-------[]--x-----xx-[]--------[]--x-----xxxx----------xxX-x--B---
------xx<>-x-xx-[]---[]-----XXXXXXX-------[]---x---xx--[]--------[]---x---xx<>-x--------xx-X--x-b---
xxxxxxx-[]--xx--[]---[]----XXXXXXXX-------[]----xxxx---[]--------[]-E-Exxxx-[]-Exxxxxxxxx--X---xxxxx
XXXXXXXXXXX-XXX-XX--XXXXX-XXXXXXXXXXXXXXXXXXXXXXXXXXXXXXXXXXXXXXXXXXXXXXXXXXXXXXXXXXXXXXXXXXXXXXXXXX