----------------------------------------------------------------------------------------------------
----------------------------------------------------------------------------------------------------
-------------------E--------------------------------------------------------------------------------
----------------------------------------------------x-----------------------------------------------
-----oo--------------------------------------------xxxxxxxxxx---------------------------------xxxxxx
----------------SSS?SSSS---------------------------xSQSSSSSS-x-------------------------------xx--QQQ
---------------------------------------------------x----------x-----------------------------xx------
---------------------------------------------------x----------Ex---------------------------xx------E
xxx-----------------------------------------------xx---------<>-x------------------------xxx-----SSS
<>-x------------SSSSSSSS-------------xxxx--------xxX-?----E--[]--x----------------------xx<>--------
[]--x-----xxxx----------------------xx<>-x------xx-X-----<>--[]---x--------------------xx-[]-------X
[]---x---xx<>-x------E-------------xx-[]--x----xx--X-----[]--[]----x----xxxxx-------SSxx--[]-------X
[]-E-Exxxx-[]-Exxxxxxxxxxxxxxxxxxxxx--[]---xxxxxE--X-----[]--[]-----xxxxx----xxxxxxxxxx---[]----E--X
XXXXXXXXXXXXXXXXXXXXXXXXXXXXXXXXXXXXXXXXXXXXXXXXXXXXXXXXXXXXXXXXXXXXXXXXX---XXXXXXXXXXXXXXXXXXXXXXXX