----------------------------------------------------------------------------------------------------
----------------------------------------------------------------------------------------------------
----------------------------------------------------------------------------------------------------
----------------------------------------------------------------------------------------------------
-------------------------------------------------------------------------------------------------xxx
------------xxxx-----------E--S---SSSSSSSSS----------------------xxxxx--------------------------xxXX
------------x<>-x---------<>------------------------------------xx-<>-x------------------------xxXXX
------------x[]--x--------[]-----------------------------------xx--[]--x----------------------xxXXXX
------E----xx[]---x-------[]------------xxxx-----------------xxx---[]---x--------------------xxXXXXX
----------xxS[]----xxx---SXXS----------xx--xxx-xxx---------xxx<>--QQQ?---x------------------xxXXXXXX
--oo-----xx--[]----<>-x------xxxx-----xx------xx--xxx-----xx<>[]----------x-------xxxx-----xxXXXXXXX
--oo----xx---[]----[]--x----xx<>-x---xx-------<>--<>-x---xx-[][]-----------x-----xx<>-x---xxXXXXXXXX
xxxxxxxxx----[]----[]---xxxxx-[]--xxxx--------[]--[]--xxxx--[][]------E-----xxxxxx-[]--xxxxXXXXXXXXX
XXXXXXXXXXXXXXXXXXXXXXXXXXXXXXXXXXXXXX------XXXXXXXXX-XXXXXXXXXXXX----X---XXXXXXXXXXXXXXXXXXXXXXXXXX