----------------------------------------------------------------------------------------------------
----------------------------------------------------------------------------------------------------
----------------------------------------------------------------------------------------------------
----------------------------------------------------------xxx----------------------------o----------
---------------------------------------------------------xxX-x--------------------------------------
----SSSSSS--------------xxxxx---------------------------xxXX--x------------------------SSS----------
--E--------------------xx-<>-x-------------------------xxXXX---x------------------------------------
---xxxxx--------------xx--[]--x-----------------------xxXXXX----x-------------------xxxxxxxx--------
-xxx----xx----------xxx---[]---x---------------------xxXXXXX-----x----------------xxx---x---xxx-----
xx<>---<>-x--------xx<>--QQQ?---x-------------------xxXXXXXX------x---------B----xx<>---S---<>-x----
x-[]---[]--x------xx-[]----------x--------xxxx-----xxXXXXXXX-------x--------b---xx-[]-------[]--x---
--[]---[]---x----xx--[]-----------x------xx<>-x---xxXXXXXXXX--------x-------B--xx--[]-------[]---x-x
--[]---[]----xxxxx---[]------E-----xxxxxxx-[]--xxxxXXXXXXXXX-------X-xxxxxxxxxxx---[]----E--[]----xx
XXXX---XX--XXXXXXXXXXXXX-----X---XXXXXXXXXXXXXXXXXXXXXXXXXXXXXXXXX-XXXXXXXXXXXXXXXXXXXXXXXXXXXXXXXXX