----------------------------------------------------------------------------------------------------
----------------------------------------------------------------------------------------------------
----------------------------------------------------------------------------------------------------
----------------------------------------------------------------------------------------------------
------------------------------------------------------------------------------------------xxx-------
------------------------------------------------------------------------------xxx--------xx--x------
---------------------------------------------xxx-----------------------------xx--x------xx----x-----
----------xxxxxx----------------------------xxX-x---------------------------xx----x----xx------x----
------xxxxx--<>-x--------------------------xxXX--xo------o----o------------xx------xxxxx--------x---
----xxx--<>--[]--x------------------------xxXXX---x------------------xxxxxxx-------XXXXX---------x--
---xx<>--[]--[]---x----------------------xxXXXX----x----------------xx----x-----------------------x-
--xx-[]--[]--[]----x--------------Q?----xxXXXXX-----x--xxxxxxxxxx--xxX---XX------------------------x
xxx--[]--[]--[]-----xxxxxxxxxxxxxxxxxxxxxXXXXXX------xxx----x----xxx-X-E-XX------------------------X
XXXX-XX--XX--XXXXXXXXXXXXXXXXXXXXXXXXXXXXXXXXXXXXXXXXXXX---XX---XXXXXXXXXXX-----------------------XX