----------------------------------------------------------------------------------------------------
----------------------------------------------------------------------------------------------------
---------------------------------------SSSSSSSSSSSSSSSSSSSSSSSSSS-------------------------------S---
-------------------------------------------[]----[]------SSSSSSSS-------------------XXXXXXXXXX--S---
----------------------xxxxx----------------[]----[]------SSSSSSSS------------------XX-----------S---
---------------------xxXX--x---------------[]----[]---QQQSSSSSSSS-----------------XXX-----------S---
--xxxx--------------xxXXX---x--------------<>----[]------SSSSSSSS----------------XXXX-----------S---
-xxXX-x------------xxXXXX----x-------------------[]-xxx-SSSSSSSSS---------------XXXXX-----------S---
xxXXX--x----------xxXXXXX-----x------------------[]--xSxSSSSSSSSS--------------XXXXXX-----------S---
xXXXX---x--------xx-XXXXX------x-----------------[]-x-SSSSSSSSSSS--------E----XXXXXXX-----------S---
XXXXX----x------xx--XXXXX-------x----------------<>xx-SSSSSSSSSSS-------<>---XXXXXXXX----<>-----S---
XXXXX-----x----xx--XXXXXX--------xx-------xxx-----xx--SSSSSSSSSSS--<>---[]--XXXXXXXXX----[]-----S---
XXXXX------xxxxx--XXXXXXX--------X-xxxxxxxx--xxxxxx---SSSSSSSSSSS--[]---[]-XXXXXXXXXX----[]-----Sxxx
XXXX--XXXXXXXXXXXXXXXXXXXXXXXXXXXXXXXXXXXXX--XXXXXXE--XXXXXXXXXXX--XX---XXXXXXXXXXXXXXXXXXXXXXXXXxXX