----------------------------------------------------------------------------------------------------
----------------------------------------------------------------------------------------------------
----------------------------------------------------------------------------------------------------
----------------------------------------------------------------------------------------------------
----------------------------------------------------------------------------------------------------
----------------------xxxxS-------SSS---------------------------------------------------------------
---------------------xx--xxx------------------------------------------------------------------------
--------------------xx------x-xxx-------------------------------------------------------------------
-------------------xx----E-EExx--xx-------------E---?----------------E------------------------------
QE--SS------------xxX--------XX-XX-x-----------<>------ESSS----E----<>------------------E--S--------
<>----------E----xxXXX-------XX-XX--x-------------------------<>-----------------------<>---------E-
[----------<>---xxXXXX-------XX-XXX--x------------------------------------xxxxx------------------<>-
xxxxxxxxxxxxxxxxxXXXX--------X--XXX--Exxxxxxxxxxxxxxxxxxxxxxxxxxxxxxxxxxxxx----xxxxxxxxxxxxxxxxxxxxx
XXXXXXXXXXXXXXXXXXXXX--------X--XXXXXXXXXXXXXXXXXXXXXXXXXXXXXXXXXXXXXXXXXXX---XXXXXXXXXXXXXXXXXXXXXX