----------------------------------------------------------------------------------------------------
----------------------------------------------------------------------------------------------------
SSSSSSSSSSSSSSSSSSSSSSSSSSSSSSSSSSSSSSSSSSSSSSSSSSSS-?SSSSSSSSSSSSSSSSSSSSSSSSSSSSSSSSSSS-----------
[--S-------------SS--SSSSSS--SSSS------SSSS------------------------------SSSS-----------------------
[--S-------------SS--SSSSSS--SSSS--E---SSSS------------------------------SSSS-----------------------
[oo-oooo-------SS--------SS---S----SS----------ooooooo-----------------xxSSSS-------------xx--xxxxx-
[-x------------SS--------SS---S----SS---------------------------------xx-x---------------xx-xxx----x
[SS-SSSS-S-----SS--------SS---S----SS----------SSSSSSS---------------xx---x-------------xx--XXX-----
<SSoS--SoS-----SS----ooooSS---So??-SS---E------SSSSSSS--------------xx----oxxx------xxxxx-----------
-SSSS--SSS-----SSSS--SSSSSS---SSS--SS--SSSS-----------------------xxx----S?SS-x----xx-XXX-----------
-----------------SS-------------------EE-------------------------xx<>----SSSS--x--xx-----------SSS-S
-----------------SS-----------------------xxxxx-----------------xx-[]----SSSS---xxx------------SSS-S
xxxxxxxxxxxxxxxxxxxxxxxxxxxxxxxxxxxxxxxxxxx----xxxxxxxxxxxxxxxxxx--[]--------EE--xX------------SSS-S
XXXXXXXXXXXXXXXXXXXXXXXXXXXXXXXXXXXXXXXXXXX---XXXXXXXXXXXXXXXXXXXXXXXXXXXXXXXXXXXXX---------XXXSSS-S