----------------------------------------------------------------------------------------------------
----------------------------------------------------------------------------------------------------
------------------------------------------------------------------------------------xxxx------------
----------------------xxx---------------------------------------------------xxxxx--xx---x-----------
------------xxxx----xxx--x-------------------------------------------------xx----xxx-----xxxxxx-----
-----------xx---x--xxXS---x---------------------------------Q-------------xxX-----x-------x----x----
----------xx-----xxxEX-----x-------------------------------[]------------xxXX----XX------XX-----x---
---------xx-------xXXX------x------------------------------[]-----------xxXXXXX------------------x--
E------xxx--------XXXXS------x------------------B----------[]----------xxXXXX---------------------xx
>-----xx<>-------XXXXX--------x---------B-------b----------[]-----xxxxxxXXXXX----------------------x
]----xx-[]------XXXXXX---------x--------b--?-B------?QQ----<>----xxE--xXXXXXX----------------------X
B---xx--[]-----XXXXXXX----------x-------B----b------------------xx<>-XXXXXXXX-E-------------------XX
xxxxx---[]----XXXXXXXX---------X-xxxxxxxxxxxxxxxxxxxxxxxxxxxxxxxx-[]-XXXXXXXX<>------------------XXX
XXXXXXXXXXXXXXXXXXXXXXXXXXXXXX-XXXXXXXXXXXXXXXXXXXXXXXXXXXXXXXXXXXXXXXXXXXXXX[]------------------XXX