-----------------------------------------------------------------xxxxx------------------------------
xxxxxxxxxxxxxxxxxxxxxxxx--------------xxxxxxxxxxxxxxxxxxxxxxxxxxxx-XX-xxxxxxxxxxxxxxxxxxxxxxxxxxx---
SSSSSSSSSSSSSSSSSSSSSSS-x-----SSSS---xxSSSSSSSSSSSSSSSSSSSSSSSSSSS----SSSSSSSSSSSSSSSSSSSSSSSSSSS---
-------------------------x----------xx--------------------------------SSSSSSSSSSSSSSSS--------------
--------------------------x----?---xx---------------------------------SSSSSSSSSSSSSSSS--------------
---------------------------x--S??-xx----------------------------------SSSSSSSSSSSSSSSS-----E--------
----------------------------x----xxXXX--------------------------------S-------------------<>--------
-----------------------------x--xx------------------------------------S-------------------[]--------
-------------------E----------xxx---------------------E----------------?oooooooooo--------[]--------
--E---------------<>------XXX-SSSS----------------E--<>----------------??SSSSSSSSS----XX--[]--------
-<>------------XX-[]--XXX------------------E-----<>--[]----------XX------------------XXX--[]---SS---
-]]-----------XXX-[]--XXX-----------------<>-----[]--[]---------XXXXX---------------XXXX--[]---SS---
--]-------E-E-XXX-[]--XXX-----------------[]---E-[]--[]--------XXXX-----------EE---XXXXX--[]---SSxxx
XXXXXXXXXXXXXXXX--XX--XX------XXXX------XXXXXXXXXXXXXXX--XXXXXXXXX----XXXXXXXXXXXXXXXXXXXXXXX--XXXXX