----------------------------------------------------------------------------------------------------
---------------------------------------------------------------------------------------xxxxx--------
------------------------------------------------------------oo------------------------xx----x-------
-------------------------------------------------------------------------xxx-----xxx--xQ-----xxx----
--------------------------xxxxx---------------------------------------xxxx-oxoooxx--xxx-----XXX-x---
-----------------------E-xxXXX-x----------------------------XXX------xx-XX---x-xx----x-----------x--
------------------------xxXXXX--x-----------------------------------xx--------xx-----XX-----------x-
x----xxxxx-------------xxXXXXX---x---------------------------------xx---------XX-------------------x
-x-xxx----x----------xxxXXXXXX----x---------------------------xxxxxx--------------------------------
--xx<>-----xx-------xx<>XXXXXX-----x-----------------XXXX----xxXXXXX-----------------------------XXX
-E<>[]----<>-x-----xx-[]XXXXXX------x-----------------------xx--------------------------------------
<>[][]----[]--x---xx-X[]XXXXXX-------xxx-------xxx---xxx---xx--------------------XXXXX--------------
[][][]----[]---xxxx-XX[]XXXXXX-------XX-xxxxxxxx--xxxx--xxxx----------------------------------------
XXXXXXXXXXXXXXXXXXXXXXXXXXXXXXXXXXXXXXXXXXXXXXXX--XXXX--XXXX---------XXXX--XXXX---------------------