----------------------------------------------------------------------------------------------------
----------------------------------------------------------------------------------------------------
---------------------------------------------------------------------?------------------------------
----------------------------------------------------------------------------------------------------
----------------------------------------------------------------------------------------------------
----------------------------------------------------SSSSS-------------------xxxxx------xxxx---------
-----------------------------------------------------------------------SS--xx----x----xxXX-x--------
--------------------------------------------------------------------------xxX-----x--xxXXX--x-------
----------------------------xxxxx--------------------E-------------SS----xxXX------xxxXXXX---x------
-xxx----------------------xxx----x------------------SSSSS-xxx-----------xxXXX-------xXXXXX----x-----
xxX-x--------------------xx<>-----xx---------xxxx--------xxX-x--B------xxXXXX------XXXXXXX-----x----
x-X--x----------------B-xx-[]----<>-x---B---xx<>-x------xx-X--x-b----xxxXXXXX-----XXXXXXXX------x---
--X---xxxxxxxxxxxxxxxxxxx--[]-E--[]--xxxxxxxx-[]--xxxxxxx--X---xxxxxxx-XXXXXX----XXXXXXXXX-------xxx
XXXXXXXXXXXXXXXXXXXXXXXXXXXXXXXXXXXXXXXXXXXXXXXXXXXXXXXXXXXXXXXXXXXXXX-XXXXXXXXXXXXXXXXXXXXXXXXXXXXX