----------------------------------------------------------------------------------------------------
----------------------------------------------------------------------------------------------------
SSSSSSSSSSSSSS?SSSSSSSSSSSSSSSSSSSSSSSSSSSSSSSSSSSSSSSSSSSSSSSS-------------------------------------
SSSS------------------------------------------------------------------------------------------------
SSSS-------------------------------------------------------------XXX--------------------------------
---------oooooo------------------------------------------------------------------XXX----------------
-------------------------------xx-------------------------------------------------------------------
---------SSSSSS---------------xx-x-xxx--------------------------------------------------------------
-E-------SSSSSS--------------xx---xx--x---------------------xxxxx-----SSSSSS??--------------------xx
SSSS-----------------------xxx----<>---x------xxxx---------xxXXX-xxxx----------------------------xxX
E-------------------------xx<>----[]----xxx--xxSS-x-------xxEXXX-XXX-x--------------------------xx--
---xxxxxx----------------xx-[]----[]----<>-xxx-SS--x-----xxXXXXX------x-------xxx---------xxxxxxx---
xxxx-----xxxxxxxxxxxxxxxxx--[]----[]--E-[]--x--SS---xxxxxxXXXXXX-------xxxxxxxx--xxxxxxxxxx--XXXX---
XXXX----XXXXXXXXXXXXXXXXXXXXXXXXXXXXXXXXXXXXX--XX--XXXXXXXXXXXX-------XXXXXXXXX--XXXXXXXXXX---------