------------------------------xxx-------------------------------------------------------------------
-----------------------------xx--x------------------------------------------------------------------
---------xxxx------xxxx-----xx----x--------------xxxx--?--------------------------------------------
--------xx<>-x----xx--xxx--xx------x-ooxxx------xx---x---xxx------xx--------------------------------
-------xx-[]--x--xx------xxx--------xxxx--x----xx-----xxxx--x----xx-x--------xxx--------------------
------xxXX[]X--xxx-------XXX--------XXXX---x--xx------XXXX--ox--xx---x------xx--x-------xx----------
-----xx---------x---------------------------xxx-------------o-xxx-----x----xx----x-----xx-x-E-------
----xx--------XXX---------------------------XXX---------------XXX------x--xx------x---xx---x--------
-xxxx-------------------------------------------------------------------xxx--------xxxx-----x-------
xxXEXXX-----------------------------------------------------------------XXXEXX-----XXXX------x------
x-----------------------------E-----E--------------------------------------------E------------x-----
XX---------------------------<>----<>---------------------XXX----------------------------------x----
-------------------XXX-------[]----[]-----------------------------------------------------------xxxx
XX--------------------------X[]X--X[]XXXXX-------XXEX--------------XXXXX------------------------XXXX