----------------------------------------------------------------------------------------------------
----------------------------------------------------------------------------------------------------
----------------------------------------------------------------------------------------S-----------
----------------------------------------------------------------------------------------------------
----------------------------------------------------------------------------------------------------
--------------------------SSSSSSSS----------------------------------------------------XXXX----------
--------------------------------------------------------------------------------------XXX-----------
----------------------------------------------------------------------------------------------------
---------------xxx----------xxxxxxx--------------------------xxxxx-xxxxx-Exxxxx--xxx----------------
--------------xx--x-------xxxSSSSS-x----QQQQ-------------xxxxx----xx----xxx----xxx--x---------------
QQQ----------xx----x-----xx<>-------x-------------------xx-XXX---XXX----XXX----XXX---x--------------
------------xx------xxx-xx-[]--------x----E------------xx--XX----XX-----XX-----XX-----xx------------
xxxxxxxxxxxxx-------XX-xx--[]---------xxxxxxxxxxxxxxxxxxX----------------------------XX-xxxxxxxxxxxx
XXXXXXXXXXXXX-------XXXXXXXXXXXXXXXXXXXXXXXXXXXXXXXXXXXXX----------------------------XXXXXXXXXXXXXXX