----------------------------------------------------------------------------------------------------
----------------------------xxx---------------------------------------------------------------------
---------------------------xx--x--------------------------------------------------------------------
--------------------------xx----xx------------------------------------------------------------------
-------------------------xx-----E-xxxxxx------------------------------------------------------------
---------S----S--------xxx---------x----x-------SSSSSS------------------------------SSSSSSSSSSSSS---
----------------------xx-S--------<>-----x----------------------------------------------------------
---------------------xx-----------[]------xxxx------xxxxxx------------------------------xxxxxxx-----
--------xxxx--------xx------------[]-------xB-xxxxxxx--<>-x---Q--Q--?-----------------xxxSSSSS-x----
-------xx<>-x------xx-------X-----XX-------XXXXESSSS?--[]--x--------------S---------xxxSS-------x--Q
x-----xx-[]--x----xxE---------------------XXXXXX-------[]---x-----------E----------xx<>----------x--
-x---xx--[]---x--xx<>--------------------XXXXXXX-------[]----x------E-----xxxxxx--xx-[]-----------x-
--xxxx---[]----xxx-[]-----X-------------XXXXXXXX-------[]-----xxxxxxxxxxxxx---X-xxx--[]----E---EE--x
XXXXXXXXXXXXXXXXXXXXXXXXXXX-------------XXXXXXXXXXXXXXXXXXXXXXXXXXXXXXXXXXX---XXXXXXXXXXXXXXXXXXXXXX