----------------------------------------------------------------------------------------------------
-------------------------------------------------------------------------xxx------------------------
--------------------------------------------E---------------------------xx--x-----------------------
-----------------------------------------------------------------------xx----xx---------------------
----------------------------------------------------------------------xx-----E-xxxxxx---------------
------------------------------------SSSSSSSS?S--------S----S--------xxx---------x----x-------SSSSSS-
-----ES--------------E---------------[]----------------------------xx-S--------<>-----x-------------
-----------QQQ------<>---------------[]---------------------------xx-----------[]------xxxx-------xx
--------------------[]---------------[]--------------xxxx--------xx------------[]-------xB-xxxxxxxx-
-----------------QQQQQQQQQQ----------[]-------------xx<>-x------xx-------X-----XX-------XXXXESSSSSS-
xx-----------------------------------<>------------xx-[]--x----xxE---------------------XXXXXX-------
B-x----------xxxxx-------------------xxx----------xx--[]---x--xx<>--------------------XXXXXXX-------
b--xxxxxxxxxxxB---xxxxxxxxxxxxxxxxxxxxE-xxxxxxxxxxx---[]----xxx-[]-----X-------------XXXXXXXX-------
XXXXXXXXXXXXXXX--XXXXXEEXXXXXXXXXXXXXXXXXXXXXXXXXXXXXXXXXXXXXXXXXXXXXXXX-------------XXXXXXXXXXXXXXX