----------------------------------------------------------------------------------------------------
----------------------------------------------------------------------------------------------------
----------------------------------------------------------------------------------------------------
----------------------------------------------------------------------------------------------------
---------------xxx----------------------------------------------------------------------------------
x-------------xx--x------------xxx---------E--------------------------------------------------------
-x-------xxxxxx----x------xxxxxx--x------------E----------------------------------------------------
--x-----xxXXXXX-----x----xxXXXXX---x---E-----------------------------------------------------------x
---x---xxXXXX--------x--xxXXXX------x------------------------------------------------------------xxx
----xxxxXXXX----------xxxXXXXX----E--x----------------------------------------xxxx-------S?S----xx<>
---XXXXXXXXX-----------xXXXXXX---<>---x-----------------?QQ------------------xxXX-x------------xx-[]
--XXXXXXXXXX----------XXXXXXXX---[]----x-------------------------xxx-------Exx-XXX-xxx--------xx--[]
-XXXXXXXXXX-----------XXXXXXXX---[]-----x---xxxxx---B-----------xx--xxxxxxxxx--XXXXXX-xxxxxxxxx---[]
XXXXXXXXXXX-----------XXXXXXX----[]--E---xxxx----xxxxxxxxxxxxxxxx---XXXXXXXXX--XXXXXXXXXXXXXXXXXXXXX