----------------------------------------------------------------------------------------------------
----------------------------------------------------------------------------------------------------
SS]?SSSSSSSSSSSSSSSSSSSSSSSSSSSSSSSSSSSSSSSSSSSSSSSSSSSSSSSSSSSSSSSSSSSSSSSSSSSSSSS------------?----
----------------------------------------------------------------------------------------------------
-------------------------------------------------------------------------------------XXX------------
-ooo--------------------------------oooo------------------------------------------------------------
-------------------xx----------------------------------------------------------------------------SS-
-SSS--------------xx-x-xxx--------S-SSSS-S-------------xxx------------------------------------------
-SSS-------------xx---xx--x-------SoS--SoS-----------xxx--x---------------------xxxxx-----SSSSS----x
---------------xxx----<>---xx-----SSS--SSS----------xx<>---x------xxxx---------xxXXX-xxxx---------xx
--------------xx<>----[]-----xx--------------------xx-[]----xxx--xxSS-x-------xxEXXX-XXX-x-------xxX
o------------xx-[]----[]----XX-x------------------xx--[]----<>-xxx-SS--x-----xxXXXXX------x----xxxXX
xxxxxxxxxxxxxx--[]----[]--E-XX--xxxxxxxxxxxxxxxxxxx---[]--E-[]--x--SS---xxxxxxXXXXXX-------xxxxx-XXX
XXXXXXXXXXXXXXXXXXXXXXXXXXXXXXXXXXXXXXXXXXXXXXXXXXXXXXXXXXXXXXXXX--XX--XXXXXXXXXXXX-------XXXXXX-XXX