----------------------------------------------------------------------------------------------------
--------------------------------------------------------------------------------------------------xx
-------------------------------------------------------------------------------------------------xx-
------------------------------------------------------------------------------------------------xx--
------------------------------------------------------------------------------------------xxxxxxx---
---------------------------------------------EXX-------------------------------------xxxxxx---XXX---
--------------------------------------------EXXX------------------------------------xxXXXXX---------
------------------------------E------------EXXXX----------------------------------Exx---------------
-------------------------------XXX------X--XXXXX----------------------------------xx----------------
xx----------------------------------------XXXXXX--------------xxxxxxxxxxxxxxxxxxxxx-----------XXX---
--x-----xxxx-----------------------------XXXXXXX-------x-----xxXXXXXXXXXXXXXXXXXXXXX----------------
oo-x---xx<>-x---------------------------XXXXXXXX-------x----xxXXXX----------------------------------
oo--xxxx-[]--xxxxxxxxxxxxxxxxx---------XXXXXXXXX--------xxxxxXXXXX----------------------------------
XXXXXXXXXXX--XXXXXXXXXXXXXXXXX--------XXXXXXXXXXXXXXXXXXXXXXXXXXXX----------------------------------