----------------------------------------------------------------------------------------------------
----------------------------------------------------------------------------------------------------
----------------------------------------------------------------------------------------------------
----------------------------------------------------------------------------------------------------
----------------------------------------------------------------------------------------------------
------------------------E--S---SSSSSSSSS------------SS---SS-------------SSS------------xxx----------
-----------------------<>-------------------------------------------------------------xx--x---------
-----------------------[]------------------------------------------------------------xx----x-----xxx
-------xxxx------------[]------------xxxx---------SS--------------xxxxx------------xxx------x---xx--
x-----xx<>-x----------SXXS----------xx--xxx-xxx---------SSS---xxxxx-XX-xSSS-------xx<>-------x-xx---
-x---xx-[]--x---xxxx------xxxx-----xx------xx--xxx-----------xxXX<>-XX--x--------xx-[]--QQ----xx----
--x-xx--[]---x-xx<>-x----xx<>-x---xx-------<>--<>-x-xxxxx---xxXXX[]-XXX--x------xx--[]-------XXX----
E--xx---[]----xx-[]--xxxxx-[]--xxxx--------[]--[]--xx----xxxxXXXX[]-XXX---xxxxxxx---[]--------------
XXXXXXXXXXXXXXXXXXXXXXXXXXXXXXXXXXX------XXXXXXXXXXXX-X-XXXXXXXX-XXXXXXXXXXXXXXXXXXXXXX-------------