----------------------------------------------------------------------------------------------------
----------------------------------------------------------------------xx----------------------------
---------------------------------------------------------------------xx-xxx-------------------------
--------------------------------------------------------------------xx--XX-x------------------------
-----xxxxxx--------------------------------------------------------xx---XX--x-----------------------
----xx?SSS-x----------------------------------SSSSS---?-------xxx--xS---XX---x----------------------
----x-------x------------------------------------------------xx--x-x----XX----x---------------------
xxxxx-------Ex----------------------------------------------xx----xx----XX-----x--------------------
---xE------<>-x--------------------------------------------xx------x----XX------x-------------Q--?--
---<>---E--[]--x-------------------xxx-----S---E---------xxx-------SS---XX-------x---------Q-E-----S
---[]--<>--[]---x-----------------xxX-x-------------E---xx<>------------XX--------x----------E------
---[]--[]--[]----x-xxxxx--------Exx-X--x---------------xx-[]------------XX---------x----------------
E--[]--[]--[]-----xx----xxxxxxxxxx--X---xxxxxxxxxxxxxxxx--[]-E----------XX--------X-xxxxxxxxxxxxxxxx
XXXXXXXXXXXXXXXXXXXX---XXXXXXXXXXX--XXXXXXXXXXXXXXXXXXXXXXXXXXXXXXXXXXXXXXXXXXXXXXXXXXXXXXXXXXXXXXXX