----------------------------------------------------------------------------------------------------
-------------------------xxx------------------------------------------------------------------------
------------------------xx--x-----------------------------------------------------------------------
-----------------------xx----xx---------------------------------------------------------------------
----------------------xx-----E-xxxxxx---------------------------------------------------------------
----------S---------xxx---------x----x-------SSSSSSS----------XXXXXXXXXXXXXXXX---------------------E
-------------------xx-S--------<>-----x---------------------------[]-------[]---------------------<>
------------------xx-----------[]------xxxx--------xxx------------[]-------[]-------------XQ------[]
----xxxx---------xx------------[]-------xB-xxxxxxxxx--x-----------[]-------[]-------xxx-------Q?--QQ
---xx<>-x-------xx-------X-----XX-------XXXXESSSSSSS---x----------[]-------[]------xx<-x------------
--xx-[]--x-----xxE---------------------XXXXXX-----------x---------<>-------<>-----xx-[]-x-----------
-xx--[]---x---xx<>--------------------XXXXXXX------------x--------xxx------xxx---xx--[]--x-----xxx--
xxE--[]----xxxx-[]-----X-------------XXXXXXXX-----------B-xxxxxxxxxE-xxxxxxxE-xxxx---[]---xxxxxx--xx
XXXXXXXXXXXXXXXXXXXXXXXX-------------XXXXXXXXXXXXXXXXEXXXXXXXXXXXXXX-XXXXXXXX-XXXXX--XXXXXXXXXXX--XX