----------------------------------------------------------------------------------------------------
--------------------------------------------------------------------xx------------------------------
-------------------------------------------------------------------xx-xxx---------------------------
------------------------------------------------------------------xx--XX-x--------------------------
--xxxxxx---------------------------------------------------------xx---XX--x-------------------------
-xx?SSS-x-----------------------------------SSSSS---?-------xxx--xS---XX---x------------------------
-x-------x-------------------------------------------------xx--x-x----XX----x-----------------------
xx-------Ex-----------------------------------------------xx----xx----XX-----x----------------------
xE------<>-x---------------------------------------------xx------x----XX------x-------------Q--?----
<>---E--[]--x--------------------xxx-----S---E---------xxx-------SS---XX-------x---------Q-E------ES
[]--<>--[]---x------------------xxX-x-------------E---xx<>------------XX--------x----------E--------
[]--[]--[]----x---xxxxx-------Exx-X--x---------------xx-[]------------XX---------x------------------
[]--[]--[]-----xxxx----xxxxxxxxx--X---xxxxxxxxxxxxxxxx--[]-E----------XX--------X-xxxxxxxxxxxxxxxxxx
XXXXXXXXXXXXXXXXXXX---XXXXXXXXXX--XXXXXXXXXXXXXXXXXXXXXXXXXXXXXXXXXXXXXXXXXXXXXXXXXXXXXXXXXXXXXXXXXX