-------------------xxxxxx---------------------------------------------------------------------------
xxxxxxxxxxxxxxxxxxxx-XXX-xxxxxxxxxxxxxxxxxxxxxxxxxxx------------------------------------------------
SSSSSSSSSSSSSSSSSSSS-----SSSSSSSSSSSSSSSSSSSSSSSSSSS------------------------------------------------
-------------------------SSSSSSSSSSSSSSSS-----------------------------------------------------------
-------------------------SSSSSSSSSSSSSSSS----------------------------------------------------------x
-------------------------SSSSSSSSSSSSSSSS-----E--------------------------QQQ?QQQQQQQ?QQQQ---------xx
-------------------------S-------------------<>---------------------------------------[]---------xxX
-------------------------S-------------------[]---------------------------------------[]--------xxXX
-------E------------------?oooooooooo--------[]---------------------------------------[]-------xxXXX
---E--<>------------------??SSSSSSSSS----XX--[]----------------------------SSSSSSSSSS-<>------xxXXXX
--<>--[]-----------XX-------------------XXX--[]---SS-----------------------------------------xxXXXXX
--[]--[]----------XXXXXX---------------XXXX--[]---SS----------------------E---E-------xxx---xxXXXXXX
E-[]--[]---------XXXX------------EE---XXXXX--[]---SSxxxxxxxxxxxxxxxxxxxxxxxxxxxxxxxxxxxE-xxxxXXXXXXX
XXXXXXXX--XXXXXXXXXX-----XXXXXXXXXXXXXXXXXXXXXXX--XXXXXXXXXXXXXXXXXXXXXXXXXXXXXXXXXXXX<>-XXXXXXXXXXX