----------------------------------------------------------------------------------------------------
----------------------------------------------------------------------------------------------------
----------------------------------------------------------------------------------------------------
----------------------------------------------------------------------------------------------------
-------------------xxxxxxxxxxx----------E-E------------------xxxxxxxx-------------------------------
ESSS--------------xx--QQQ?QQQ-x-------SSSSSSS-SS-xxxx-----xxxx--XSSS-x------------------------------
-----------------xx------------x-------------E--xx---x---xx--E--X-----x-----------------------------
----------------xx------E-------x--------------xx-----x-xx---XX-X------x----------------------------
xxxx----------xxx-----SSSSSSS----x-----------xxx-------xx----XX-X-------x-------------------------xx
x<>-x--------xx<>--------------E--x---------xx<>-------<>----XX-X--------x---------B------E------xx<
-[]--x------xx-[]-------X------X---x---E---xx-[]-------[]----XX-X---------x--------b--?-B->-----xx-[
-[]---x----xx--[]-------X------X----x-----xx--[]-------[]----XX-X----------x-------B----b------xx--[
-[]----xxxxx---[]----E--X------X-----xxxxxx---[]-------[]----XX-X---------X-xxxxxxxxxxxxxxxxxxxx---[
XXX----XXXXXXXXXXXXXXXXXXXXXXXXXXXXXXXXXXXXXXXXX-------XX-XXXXX-XXXXXXXXXXXXXXXXXXXXXXXXXXXXXXXXXXXX