-------------------------------------------------------------------------------------------xxx------
------------------------------------------------------------------------------------------xx--x-----
-----------------------------------------------------------------------------------------xx----x----
-----------------------------------------------------------------------------------xxxxxxx------x---
----------------------------------------------------------------------------------xx----x--------x--
SS-------SSSS----------------------------------------------SSSSS-----SSSSS--------xX----E---------x-
----------[]-----------------xxxx-------------------------S-----------[]---------xx----<>----------x
----------[]----------------xx---xxx---------------------SS-----------[]---------x-----[]-----------
----------[]---------------xx-----x-x-------------------SSS-------?---[]-------xxx-----[]-----------
xx--------[]----------xxxxxx------S--xS----------------SSSS-----------<>------xx<>-----[]-----------
B-x-------<>---------xxE--x-----------x--------------------------------------xx-[]-----[]-----------
b--x------xxx-------xx<>-XX------------x------xxx-----xxx----------xxx-E----xx--[]-----[]-----------
B---xxxxxxxE-xxxxxxxx-[]-XX-------------xxxxxxxE-xxxxxxB-xxxxxxxxxxxB-xxxxxxx---[]-----[]------E----
XXXXXXXXXXXXXXXXEXXXXXXXXXX-------------XXXXXX<>XXXXXXXXXXXXXXXXXXXXX-XXXXXXXEXXXX-----XXXXXXX<>XXXX