Q---------------------------------------------------------------------------------------------------
----------------------------------------------------------------------------------------------------
----------------------------------------------------------------------------------------------------
----------------------------------------------------------------------------------------------------
------------------------------------------------------------------------------E---------------------
-------xxxxS-------SSS-----------------SSQSSS?SSS-------SSS------------------SQS--SQS---------------
------xx--xxx------------------------------------------------------xxxx-----------------------------
-----xx------x-xxx------------------------------------------------xxXX-x----------------------------
----xx----E-EExx--xx------------E-----------------------SSS------xxXXX--x-----------------------xxx-
---xxX--------XX-XX-x----------<>------SSSSSSSSSSS--------------xxXXXX---x---SQS--S?S----------xx--x
--xxXXX-------XX-XX--x-----------------------------------------xxXXXXX----x---------------E---xx---X
-xxXXXX-------XX-XXX--x-------------------------------xxxxx---xxXXXXXX-----x-----------------xx----X
xxXXXX--------XX-XXX--Exxxxxxxxxxxxxxxxxxxxxxxxxxxxxxxx----xxxxXXXXXXX-----ExxxxxxxxxxxxxxxxxxX----X
XXXXXX--------XX-XXXXXXXXXXXXXXXXXXXXXXXXXXXXXXXXXXXXXX----XXXXXXXXXX--XXXXXXXXXXXXXXXXXXXXXXXX----X