----------------------------------------------------------------------------------------------------
----------------------------------------------------------------------------------------------------
----------------------------------------------------------------------------------------------------
-----------------------------------------------------------------------------------------------xxxxx
----------------------------------------------------------------------------------------------xx----
-----------------------------------------------xxxxS-------SSS-------------------------------xxX----
----------------------------------------------xx--xxx---------------------------------------xxXX----
---------------------------------------------xx------x-xxx---------------------------------xxXXXXX--
------E-------------------------------------xx----E-EExx--xx-------------E----------------xxXXXX----
E----<>--------------------E--S------------xxX--------XX-XX-x-----------<>---------------xxXXXXX----
>-------------------------<>---------E----xxXXX-------XX-XX--x-----------------xxxx-----xxXXXXXX----
-----------xxxxx--------------------<>---xxXXXX-------XX-XXX--x---------------xx<>-x---xxXXXXXXX-E--
xxxxxxxxxxxx----xxxxxxxxxxxxxxxxxxxxxxxxxxXXXX--------XX-XXX--Exxxxxxxxxxxxxxxx-[]--xxxxXXXXXXXX<>--
XXXXXXXXXXXX---XXXXXXXXXXXXXXXXXXXXXXXXXXXXXXX--------X--XXXXXXXXXXXXXXXXXXXXXXXXXXXXXXXXXXXXXXX[]--